"No","COUNTY","Age","Male","Female","Total"
1,"BARINGO","Total",299456,292006,591462
2,"BARINGO",0,7195,6942,14137
3,"BARINGO",1,7647,7385,15032
4,"BARINGO",2,9244,8749,17993
5,"BARINGO",3,9254,9081,18335
6,"BARINGO",4,10078,9314,19392
7,"BARINGO","0 - 4",43418,41471,84889
8,"BARINGO",5,9794,9173,18967
9,"BARINGO",6,10080,9468,19548
10,"BARINGO",7,8702,8176,16878
11,"BARINGO",8,9475,9224,18699
12,"BARINGO",9,8493,8216,16709
13,"BARINGO","5-9",46544,44257,90801
14,"BARINGO",10,11904,11128,23032
15,"BARINGO",11,7318,7519,14837
16,"BARINGO",12,10988,9658,20646
17,"BARINGO",13,8953,8244,17197
18,"BARINGO",14,9065,8258,17323
19,"BARINGO","10-14",48228,44807,93035
20,"BARINGO",15,9707,8502,18209
21,"BARINGO",16,7991,7282,15273
22,"BARINGO",17,7691,6736,14427
23,"BARINGO",18,6692,5940,12632
24,"BARINGO",19,6544,5877,12421
25,"BARINGO","15-19",38625,34337,72962
26,"BARINGO",20,7123,6851,13974
27,"BARINGO",21,5187,5127,10314
28,"BARINGO",22,4888,5029,9917
29,"BARINGO",23,4978,5014,9992
30,"BARINGO",24,4471,4450,8921
31,"BARINGO","20-24",26647,26471,53118
32,"BARINGO",25,5534,5593,11127
33,"BARINGO",26,3538,3806,7344
34,"BARINGO",27,3635,3783,7418
35,"BARINGO",28,3148,3565,6713
36,"BARINGO",29,3287,3526,6813
37,"BARINGO","25-29",19142,20273,39415
38,"BARINGO",30,5239,5644,10883
39,"BARINGO",31,2715,2874,5589
40,"BARINGO",32,3165,3372,6537
41,"BARINGO",33,2732,2915,5647
42,"BARINGO",34,2242,2326,4568
43,"BARINGO","30-34",16093,17131,33224
44,"BARINGO",35,4300,4387,8687
45,"BARINGO",36,2164,2019,4183
46,"BARINGO",37,2229,1876,4105
47,"BARINGO",38,1602,1729,3331
48,"BARINGO",39,1968,1822,3790
49,"BARINGO","35-39",12263,11833,24096
50,"BARINGO",40,3401,3048,6449
51,"BARINGO",41,2530,2231,4761
52,"BARINGO",42,1964,1886,3850
53,"BARINGO",43,1573,1781,3354
54,"BARINGO",44,1175,1362,2537
55,"BARINGO","40-44",10643,10308,20951
56,"BARINGO",45,3308,3217,6525
57,"BARINGO",46,1650,1800,3450
58,"BARINGO",47,1770,1803,3573
59,"BARINGO",48,1046,1115,2161
60,"BARINGO",49,1380,1573,2953
61,"BARINGO","45-49",9154,9508,18662
62,"BARINGO",50,2238,2496,4734
63,"BARINGO",51,1268,1270,2538
64,"BARINGO",52,1089,1216,2305
65,"BARINGO",53,861,926,1787
66,"BARINGO",54,1258,1358,2616
67,"BARINGO","50-54",6714,7266,13980
68,"BARINGO",55,1144,996,2140
69,"BARINGO",56,994,1013,2007
70,"BARINGO",57,1032,1346,2378
71,"BARINGO",58,1263,1389,2652
72,"BARINGO",59,1244,1274,2518
73,"BARINGO","55-59",5677,6018,11695
74,"BARINGO",60,1801,1948,3749
75,"BARINGO",61,1111,984,2095
76,"BARINGO",62,791,801,1592
77,"BARINGO",63,863,880,1743
78,"BARINGO",64,583,620,1203
79,"BARINGO","60-64",5149,5233,10382
80,"BARINGO",65,1149,1325,2474
81,"BARINGO",66,517,520,1037
82,"BARINGO",67,1002,916,1918
83,"BARINGO",68,532,530,1062
84,"BARINGO",69,885,980,1865
85,"BARINGO","65-69",4085,4271,8356
86,"BARINGO",70,1209,1458,2667
87,"BARINGO",71,834,726,1560
88,"BARINGO",72,552,532,1084
89,"BARINGO",73,387,458,845
90,"BARINGO",74,462,502,964
91,"BARINGO","70-74",3444,3676,7120
92,"BARINGO",75,466,514,980
93,"BARINGO",76,275,274,549
94,"BARINGO",77,304,324,628
95,"BARINGO",78,196,205,401
96,"BARINGO",79,339,566,905
97,"BARINGO","75-79",1580,1883,3463
98,"BARINGO",80,432,649,1081
99,"BARINGO",81,157,323,480
100,"BARINGO",82,129,149,278
101,"BARINGO",83,159,241,400
102,"BARINGO",84,177,260,437
103,"BARINGO","80-84",1054,1622,2676
104,"BARINGO",85,129,226,355
105,"BARINGO",86,89,122,211
106,"BARINGO",87,116,128,244
107,"BARINGO",88,49,65,114
108,"BARINGO",89,178,300,478
109,"BARINGO","85-89",561,841,1402
110,"BARINGO",90,81,183,264
111,"BARINGO",91,54,75,129
112,"BARINGO",92,37,52,89
113,"BARINGO",93,36,53,89
114,"BARINGO",94,31,58,89
115,"BARINGO","90-94",239,421,660
116,"BARINGO",95,52,110,162
117,"BARINGO",96,20,31,51
118,"BARINGO",97,27,32,59
119,"BARINGO",98,8,25,33
120,"BARINGO",99,28,63,91
121,"BARINGO","95-99",135,261,396
122,"BARINGO","100+",60,117,177
123,"BARINGO","Not Stated",1,1,2
125,"BOMET","Total",420119,427576,847695
126,"BOMET",0,9576,9327,18903
127,"BOMET",1,10220,10056,20276
128,"BOMET",2,11130,10644,21774
129,"BOMET",3,11379,11433,22812
130,"BOMET",4,12285,11624,23909
131,"BOMET","0 - 4",54590,53084,107674
132,"BOMET",5,12154,11154,23308
133,"BOMET",6,11807,11497,23304
134,"BOMET",7,12426,12124,24550
135,"BOMET",8,11271,10979,22250
136,"BOMET",9,13383,13015,26398
137,"BOMET","5-9",61041,58769,119810
138,"BOMET",10,13057,12478,25535
139,"BOMET",11,12391,12620,25011
140,"BOMET",12,13486,13015,26501
141,"BOMET",13,13043,13414,26457
142,"BOMET",14,12718,12563,25281
143,"BOMET","10-14",64695,64090,128785
144,"BOMET",15,12985,12578,25563
145,"BOMET",16,11505,11371,22876
146,"BOMET",17,11233,10360,21593
147,"BOMET",18,8516,8032,16548
148,"BOMET",19,10757,10221,20978
149,"BOMET","15-19",54996,52562,107558
150,"BOMET",20,8028,8448,16476
151,"BOMET",21,7856,8792,16648
152,"BOMET",22,6969,7759,14728
153,"BOMET",23,7202,8431,15633
154,"BOMET",24,6345,7197,13542
155,"BOMET","20-24",36400,40627,77027
156,"BOMET",25,7061,7548,14609
157,"BOMET",26,5827,6621,12448
158,"BOMET",27,6113,7038,13151
159,"BOMET",28,4495,5394,9889
160,"BOMET",29,5393,6522,11915
161,"BOMET","25-29",28889,33123,62012
162,"BOMET",30,6147,7809,13956
163,"BOMET",31,4939,6267,11206
164,"BOMET",32,6064,7162,13226
165,"BOMET",33,5371,6471,11842
166,"BOMET",34,4743,5024,9767
167,"BOMET","30-34",27264,32733,59997
168,"BOMET",35,6102,5475,11577
169,"BOMET",36,3945,3000,6945
170,"BOMET",37,4376,3226,7602
171,"BOMET",38,2585,1970,4555
172,"BOMET",39,3703,2794,6497
173,"BOMET","35-39",20711,16465,37176
174,"BOMET",40,4187,3439,7626
175,"BOMET",41,4859,4538,9397
176,"BOMET",42,3461,3315,6776
177,"BOMET",43,3088,3226,6314
178,"BOMET",44,2285,2509,4794
179,"BOMET","40-44",17880,17027,34907
180,"BOMET",45,5215,4444,9659
181,"BOMET",46,3089,3167,6256
182,"BOMET",47,3350,3535,6885
183,"BOMET",48,1627,1693,3320
184,"BOMET",49,2478,2764,5242
185,"BOMET","45-49",15759,15603,31362
186,"BOMET",50,2561,2658,5219
187,"BOMET",51,2432,2367,4799
188,"BOMET",52,1529,1520,3049
189,"BOMET",53,1127,1182,2309
190,"BOMET",54,1471,1407,2878
191,"BOMET","50-54",9120,9134,18254
192,"BOMET",55,1247,1358,2605
193,"BOMET",56,1250,1324,2574
194,"BOMET",57,1540,1827,3367
195,"BOMET",58,2338,3231,5569
196,"BOMET",59,1904,1780,3684
197,"BOMET","55-59",8279,9520,17799
198,"BOMET",60,1872,2001,3873
199,"BOMET",61,1587,1611,3198
200,"BOMET",62,1179,1205,2384
201,"BOMET",63,1232,1322,2554
202,"BOMET",64,919,970,1889
203,"BOMET","60-64",6789,7109,13898
204,"BOMET",65,1415,1629,3044
205,"BOMET",66,833,794,1627
206,"BOMET",67,1293,1369,2662
207,"BOMET",68,530,618,1148
208,"BOMET",69,929,1099,2028
209,"BOMET","65-69",5000,5509,10509
210,"BOMET",70,1078,1414,2492
211,"BOMET",71,1086,956,2042
212,"BOMET",72,700,639,1339
213,"BOMET",73,596,640,1236
214,"BOMET",74,518,790,1308
215,"BOMET","70-74",3978,4439,8417
216,"BOMET",75,477,698,1175
217,"BOMET",76,353,475,828
218,"BOMET",77,485,565,1050
219,"BOMET",78,230,278,508
220,"BOMET",79,383,815,1198
221,"BOMET","75-79",1928,2831,4759
222,"BOMET",80,390,761,1151
223,"BOMET",81,221,467,688
224,"BOMET",82,212,243,455
225,"BOMET",83,234,269,503
226,"BOMET",84,246,445,691
227,"BOMET","80-84",1303,2185,3488
228,"BOMET",85,173,298,471
229,"BOMET",86,156,171,327
230,"BOMET",87,207,273,480
231,"BOMET",88,102,150,252
232,"BOMET",89,207,542,749
233,"BOMET","85-89",845,1434,2279
234,"BOMET",90,107,278,385
235,"BOMET",91,74,166,240
236,"BOMET",92,55,87,142
237,"BOMET",93,51,93,144
238,"BOMET",94,58,145,203
239,"BOMET","90-94",345,769,1114
240,"BOMET",95,102,116,218
241,"BOMET",96,34,36,70
242,"BOMET",97,42,40,82
243,"BOMET",98,20,41,61
244,"BOMET",99,34,127,161
245,"BOMET","95-99",232,360,592
246,"BOMET","100+",73,202,275
247,"BOMET","Not Stated",2,1,3
249,"BUNGOMA","Total",720235,760194,1480429
250,"BUNGOMA",0,17590,18022,35612
251,"BUNGOMA",1,18561,18690,37251
252,"BUNGOMA",2,19391,19437,38828
253,"BUNGOMA",3,20725,21206,41931
254,"BUNGOMA",4,21276,21062,42338
255,"BUNGOMA","0 - 4",97543,98417,195960
256,"BUNGOMA",5,23110,22433,45543
257,"BUNGOMA",6,22693,23131,45824
258,"BUNGOMA",7,22807,22704,45511
259,"BUNGOMA",8,21155,21633,42788
260,"BUNGOMA",9,25307,24745,50052
261,"BUNGOMA","5-9",115072,114646,229718
262,"BUNGOMA",10,24509,24498,49007
263,"BUNGOMA",11,23437,24067,47504
264,"BUNGOMA",12,24925,24305,49230
265,"BUNGOMA",13,25223,25694,50917
266,"BUNGOMA",14,23051,22755,45806
267,"BUNGOMA","10-14",121145,121319,242464
268,"BUNGOMA",15,23614,22915,46529
269,"BUNGOMA",16,20249,20290,40539
270,"BUNGOMA",17,21386,20482,41868
271,"BUNGOMA",18,15620,14462,30082
272,"BUNGOMA",19,17693,16689,34382
273,"BUNGOMA","15-19",98562,94838,193400
274,"BUNGOMA",20,13690,14469,28159
275,"BUNGOMA",21,12136,12850,24986
276,"BUNGOMA",22,10584,12165,22749
277,"BUNGOMA",23,11282,13035,24317
278,"BUNGOMA",24,9294,11024,20318
279,"BUNGOMA","20-24",56986,63543,120529
280,"BUNGOMA",25,10468,12509,22977
281,"BUNGOMA",26,8156,10058,18214
282,"BUNGOMA",27,9036,10535,19571
283,"BUNGOMA",28,6217,7620,13837
284,"BUNGOMA",29,7661,8901,16562
285,"BUNGOMA","25-29",41538,49623,91161
286,"BUNGOMA",30,8869,11323,20192
287,"BUNGOMA",31,7815,10278,18093
288,"BUNGOMA",32,9083,11339,20422
289,"BUNGOMA",33,7276,8854,16130
290,"BUNGOMA",34,6173,6734,12907
291,"BUNGOMA","30-34",39216,48528,87744
292,"BUNGOMA",35,8025,8014,16039
293,"BUNGOMA",36,6068,5939,12007
294,"BUNGOMA",37,6372,6069,12441
295,"BUNGOMA",38,4391,4640,9031
296,"BUNGOMA",39,5283,5385,10668
297,"BUNGOMA","35-39",30139,30047,60186
298,"BUNGOMA",40,5634,6124,11758
299,"BUNGOMA",41,6145,6945,13090
300,"BUNGOMA",42,5962,6667,12629
301,"BUNGOMA",43,5633,6258,11891
302,"BUNGOMA",44,3958,4362,8320
303,"BUNGOMA","40-44",27332,30356,57688
304,"BUNGOMA",45,6475,6340,12815
305,"BUNGOMA",46,4746,4856,9602
306,"BUNGOMA",47,5093,5180,10273
307,"BUNGOMA",48,3079,3389,6468
308,"BUNGOMA",49,3705,3771,7476
309,"BUNGOMA","45-49",23098,23536,46634
310,"BUNGOMA",50,4038,4821,8859
311,"BUNGOMA",51,3737,4325,8062
312,"BUNGOMA",52,3160,3574,6734
313,"BUNGOMA",53,2717,3472,6189
314,"BUNGOMA",54,2830,3410,6240
315,"BUNGOMA","50-54",16482,19602,36084
316,"BUNGOMA",55,3344,3784,7128
317,"BUNGOMA",56,3137,3738,6875
318,"BUNGOMA",57,3427,4605,8032
319,"BUNGOMA",58,2569,3017,5586
320,"BUNGOMA",59,3832,4025,7857
321,"BUNGOMA","55-59",16309,19169,35478
322,"BUNGOMA",60,3341,3566,6907
323,"BUNGOMA",61,2890,3301,6191
324,"BUNGOMA",62,2232,2528,4760
325,"BUNGOMA",63,2717,3197,5914
326,"BUNGOMA",64,1848,2227,4075
327,"BUNGOMA","60-64",13028,14819,27847
328,"BUNGOMA",65,2549,3119,5668
329,"BUNGOMA",66,1513,1929,3442
330,"BUNGOMA",67,2042,2728,4770
331,"BUNGOMA",68,1025,1258,2283
332,"BUNGOMA",69,1779,2035,3814
333,"BUNGOMA","65-69",8908,11069,19977
334,"BUNGOMA",70,1520,1967,3487
335,"BUNGOMA",71,1421,1906,3327
336,"BUNGOMA",72,1101,1357,2458
337,"BUNGOMA",73,1150,1551,2701
338,"BUNGOMA",74,955,1195,2150
339,"BUNGOMA","70-74",6147,7976,14123
340,"BUNGOMA",75,944,1309,2253
341,"BUNGOMA",76,752,1058,1810
342,"BUNGOMA",77,910,1567,2477
343,"BUNGOMA",78,591,672,1263
344,"BUNGOMA",79,553,829,1382
345,"BUNGOMA","75-79",3750,5435,9185
346,"BUNGOMA",80,739,1034,1773
347,"BUNGOMA",81,468,625,1093
348,"BUNGOMA",82,477,618,1095
349,"BUNGOMA",83,620,914,1534
350,"BUNGOMA",84,359,450,809
351,"BUNGOMA","80-84",2663,3641,6304
352,"BUNGOMA",85,421,594,1015
353,"BUNGOMA",86,231,383,614
354,"BUNGOMA",87,414,654,1068
355,"BUNGOMA",88,169,199,368
356,"BUNGOMA",89,284,498,782
357,"BUNGOMA","85-89",1519,2328,3847
358,"BUNGOMA",90,164,197,361
359,"BUNGOMA",91,160,226,386
360,"BUNGOMA",92,90,145,235
361,"BUNGOMA",93,62,143,205
362,"BUNGOMA",94,45,77,122
363,"BUNGOMA","90-94",521,788,1309
364,"BUNGOMA",95,109,156,265
365,"BUNGOMA",96,34,43,77
366,"BUNGOMA",97,57,131,188
367,"BUNGOMA",98,14,41,55
368,"BUNGOMA",99,24,56,80
369,"BUNGOMA","95-99",238,427,665
370,"BUNGOMA","100+",34,86,120
371,"BUNGOMA","Not Stated",5,1,6
373,"BUSIA","Total",371289,408611,779900
374,"BUSIA",0,8997,9276,18273
375,"BUSIA",1,9787,9875,19662
376,"BUSIA",2,9870,9756,19626
377,"BUSIA",3,10226,10539,20765
378,"BUSIA",4,10133,10219,20352
379,"BUSIA","0 - 4",49013,49665,98678
380,"BUSIA",5,10591,10805,21396
381,"BUSIA",6,11299,11607,22906
382,"BUSIA",7,11404,11574,22978
383,"BUSIA",8,10844,11287,22131
384,"BUSIA",9,11943,12227,24170
385,"BUSIA","5-9",56081,57500,113581
386,"BUSIA",10,12664,12508,25172
387,"BUSIA",11,11549,12209,23758
388,"BUSIA",12,13137,12968,26105
389,"BUSIA",13,12767,13021,25788
390,"BUSIA",14,12064,11977,24041
391,"BUSIA","10-14",62181,62683,124864
392,"BUSIA",15,11959,11862,23821
393,"BUSIA",16,11071,11210,22281
394,"BUSIA",17,11325,11007,22332
395,"BUSIA",18,9298,8637,17935
396,"BUSIA",19,9339,9147,18486
397,"BUSIA","15-19",52992,51863,104855
398,"BUSIA",20,8069,8370,16439
399,"BUSIA",21,6272,6784,13056
400,"BUSIA",22,5779,6841,12620
401,"BUSIA",23,5376,6546,11922
402,"BUSIA",24,4815,5882,10697
403,"BUSIA","20-24",30311,34423,64734
404,"BUSIA",25,5052,6354,11406
405,"BUSIA",26,4205,5617,9822
406,"BUSIA",27,4362,5497,9859
407,"BUSIA",28,3410,4653,8063
408,"BUSIA",29,3489,4466,7955
409,"BUSIA","25-29",20518,26587,47105
410,"BUSIA",30,4370,6313,10683
411,"BUSIA",31,3467,4675,8142
412,"BUSIA",32,4409,5953,10362
413,"BUSIA",33,3651,4843,8494
414,"BUSIA",34,3266,4085,7351
415,"BUSIA","30-34",19163,25869,45032
416,"BUSIA",35,4114,4470,8584
417,"BUSIA",36,3184,3253,6437
418,"BUSIA",37,3324,3334,6658
419,"BUSIA",38,2339,2569,4908
420,"BUSIA",39,2750,2824,5574
421,"BUSIA","35-39",15711,16450,32161
422,"BUSIA",40,3247,3797,7044
423,"BUSIA",41,2952,3484,6436
424,"BUSIA",42,3098,3577,6675
425,"BUSIA",43,2843,3128,5971
426,"BUSIA",44,2183,2407,4590
427,"BUSIA","40-44",14323,16393,30716
428,"BUSIA",45,3061,3485,6546
429,"BUSIA",46,2152,2382,4534
430,"BUSIA",47,2399,2780,5179
431,"BUSIA",48,1564,1881,3445
432,"BUSIA",49,1749,2099,3848
433,"BUSIA","45-49",10925,12627,23552
434,"BUSIA",50,2428,3542,5970
435,"BUSIA",51,2062,2773,4835
436,"BUSIA",52,1648,2142,3790
437,"BUSIA",53,1498,1929,3427
438,"BUSIA",54,1532,1895,3427
439,"BUSIA","50-54",9168,12281,21449
440,"BUSIA",55,1708,2095,3803
441,"BUSIA",56,1733,2118,3851
442,"BUSIA",57,1862,3057,4919
443,"BUSIA",58,1449,1928,3377
444,"BUSIA",59,1835,2367,4202
445,"BUSIA","55-59",8587,11565,20152
446,"BUSIA",60,2007,2638,4645
447,"BUSIA",61,1615,1978,3593
448,"BUSIA",62,1269,1637,2906
449,"BUSIA",63,1317,1662,2979
450,"BUSIA",64,1047,1521,2568
451,"BUSIA","60-64",7255,9436,16691
452,"BUSIA",65,1374,1932,3306
453,"BUSIA",66,943,1209,2152
454,"BUSIA",67,1366,1881,3247
455,"BUSIA",68,627,764,1391
456,"BUSIA",69,975,1390,2365
457,"BUSIA","65-69",5285,7176,12461
458,"BUSIA",70,1235,2009,3244
459,"BUSIA",71,966,1158,2124
460,"BUSIA",72,737,834,1571
461,"BUSIA",73,616,751,1367
462,"BUSIA",74,627,927,1554
463,"BUSIA","70-74",4181,5679,9860
464,"BUSIA",75,581,866,1447
465,"BUSIA",76,466,560,1026
466,"BUSIA",77,624,828,1452
467,"BUSIA",78,303,386,689
468,"BUSIA",79,419,800,1219
469,"BUSIA","75-79",2393,3440,5833
470,"BUSIA",80,474,845,1319
471,"BUSIA",81,347,465,812
472,"BUSIA",82,271,327,598
473,"BUSIA",83,341,383,724
474,"BUSIA",84,259,437,696
475,"BUSIA","80-84",1692,2457,4149
476,"BUSIA",85,197,355,552
477,"BUSIA",86,249,263,512
478,"BUSIA",87,251,400,651
479,"BUSIA",88,126,152,278
480,"BUSIA",89,189,436,625
481,"BUSIA","85-89",1012,1606,2618
482,"BUSIA",90,90,215,305
483,"BUSIA",91,99,120,219
484,"BUSIA",92,48,63,111
485,"BUSIA",93,55,62,117
486,"BUSIA",94,38,107,145
487,"BUSIA","90-94",330,567,897
488,"BUSIA",95,42,76,118
489,"BUSIA",96,25,33,58
490,"BUSIA",97,45,47,92
491,"BUSIA",98,8,34,42
492,"BUSIA",99,15,55,70
493,"BUSIA","95-99",135,245,380
494,"BUSIA","100+",29,98,127
495,"BUSIA","Not Stated",4,1,5
497,"ELGEYO/MARAKWET","Total",217344,216548,433892
498,"ELGEYO/MARAKWET",0,5401,5427,10828
499,"ELGEYO/MARAKWET",1,5606,5390,10996
500,"ELGEYO/MARAKWET",2,5683,5617,11300
501,"ELGEYO/MARAKWET",3,6106,6192,12298
502,"ELGEYO/MARAKWET",4,6504,6457,12961
503,"ELGEYO/MARAKWET","0 - 4",29300,29083,58383
504,"ELGEYO/MARAKWET",5,6434,6266,12700
505,"ELGEYO/MARAKWET",6,6476,6380,12856
506,"ELGEYO/MARAKWET",7,6391,6241,12632
507,"ELGEYO/MARAKWET",8,5722,5618,11340
508,"ELGEYO/MARAKWET",9,6651,6308,12959
509,"ELGEYO/MARAKWET","5-9",31674,30813,62487
510,"ELGEYO/MARAKWET",10,6635,6379,13014
511,"ELGEYO/MARAKWET",11,5869,6045,11914
512,"ELGEYO/MARAKWET",12,6733,6515,13248
513,"ELGEYO/MARAKWET",13,6381,6489,12870
514,"ELGEYO/MARAKWET",14,6290,6090,12380
515,"ELGEYO/MARAKWET","10-14",31908,31518,63426
516,"ELGEYO/MARAKWET",15,6221,6015,12236
517,"ELGEYO/MARAKWET",16,5605,5546,11151
518,"ELGEYO/MARAKWET",17,5695,5310,11005
519,"ELGEYO/MARAKWET",18,4299,4089,8388
520,"ELGEYO/MARAKWET",19,5328,5013,10341
521,"ELGEYO/MARAKWET","15-19",27148,25973,53121
522,"ELGEYO/MARAKWET",20,4756,4523,9279
523,"ELGEYO/MARAKWET",21,4280,4126,8406
524,"ELGEYO/MARAKWET",22,3898,3808,7706
525,"ELGEYO/MARAKWET",23,3862,3924,7786
526,"ELGEYO/MARAKWET",24,3405,3534,6939
527,"ELGEYO/MARAKWET","20-24",20201,19915,40116
528,"ELGEYO/MARAKWET",25,3947,3926,7873
529,"ELGEYO/MARAKWET",26,2961,3146,6107
530,"ELGEYO/MARAKWET",27,3134,3159,6293
531,"ELGEYO/MARAKWET",28,2281,2372,4653
532,"ELGEYO/MARAKWET",29,2754,2798,5552
533,"ELGEYO/MARAKWET","25-29",15077,15401,30478
534,"ELGEYO/MARAKWET",30,3157,3391,6548
535,"ELGEYO/MARAKWET",31,2342,2468,4810
536,"ELGEYO/MARAKWET",32,2867,3121,5988
537,"ELGEYO/MARAKWET",33,2468,2729,5197
538,"ELGEYO/MARAKWET",34,2094,2332,4426
539,"ELGEYO/MARAKWET","30-34",12928,14041,26969
540,"ELGEYO/MARAKWET",35,3308,3136,6444
541,"ELGEYO/MARAKWET",36,1878,1606,3484
542,"ELGEYO/MARAKWET",37,2026,1717,3743
543,"ELGEYO/MARAKWET",38,1222,1130,2352
544,"ELGEYO/MARAKWET",39,1724,1644,3368
545,"ELGEYO/MARAKWET","35-39",10158,9233,19391
546,"ELGEYO/MARAKWET",40,2058,1771,3829
547,"ELGEYO/MARAKWET",41,2049,1942,3991
548,"ELGEYO/MARAKWET",42,1956,1845,3801
549,"ELGEYO/MARAKWET",43,1685,1663,3348
550,"ELGEYO/MARAKWET",44,1117,1198,2315
551,"ELGEYO/MARAKWET","40-44",8865,8419,17284
552,"ELGEYO/MARAKWET",45,2914,2632,5546
553,"ELGEYO/MARAKWET",46,1492,1504,2996
554,"ELGEYO/MARAKWET",47,1583,1575,3158
555,"ELGEYO/MARAKWET",48,798,845,1643
556,"ELGEYO/MARAKWET",49,1129,1180,2309
557,"ELGEYO/MARAKWET","45-49",7916,7736,15652
558,"ELGEYO/MARAKWET",50,1386,1472,2858
559,"ELGEYO/MARAKWET",51,1005,1083,2088
560,"ELGEYO/MARAKWET",52,835,875,1710
561,"ELGEYO/MARAKWET",53,599,651,1250
562,"ELGEYO/MARAKWET",54,1027,969,1996
563,"ELGEYO/MARAKWET","50-54",4852,5050,9902
564,"ELGEYO/MARAKWET",55,967,840,1807
565,"ELGEYO/MARAKWET",56,900,997,1897
566,"ELGEYO/MARAKWET",57,904,1117,2021
567,"ELGEYO/MARAKWET",58,1058,1179,2237
568,"ELGEYO/MARAKWET",59,1054,951,2005
569,"ELGEYO/MARAKWET","55-59",4883,5084,9967
570,"ELGEYO/MARAKWET",60,1186,1199,2385
571,"ELGEYO/MARAKWET",61,944,919,1863
572,"ELGEYO/MARAKWET",62,617,585,1202
573,"ELGEYO/MARAKWET",63,663,769,1432
574,"ELGEYO/MARAKWET",64,457,489,946
575,"ELGEYO/MARAKWET","60-64",3867,3961,7828
576,"ELGEYO/MARAKWET",65,932,940,1872
577,"ELGEYO/MARAKWET",66,403,403,806
578,"ELGEYO/MARAKWET",67,838,788,1626
579,"ELGEYO/MARAKWET",68,373,352,725
580,"ELGEYO/MARAKWET",69,719,766,1485
581,"ELGEYO/MARAKWET","65-69",3265,3249,6514
582,"ELGEYO/MARAKWET",70,741,922,1663
583,"ELGEYO/MARAKWET",71,572,669,1241
584,"ELGEYO/MARAKWET",72,379,382,761
585,"ELGEYO/MARAKWET",73,336,388,724
586,"ELGEYO/MARAKWET",74,341,444,785
587,"ELGEYO/MARAKWET","70-74",2369,2805,5174
588,"ELGEYO/MARAKWET",75,366,446,812
589,"ELGEYO/MARAKWET",76,285,308,593
590,"ELGEYO/MARAKWET",77,247,309,556
591,"ELGEYO/MARAKWET",78,143,145,288
592,"ELGEYO/MARAKWET",79,264,488,752
593,"ELGEYO/MARAKWET","75-79",1305,1696,3001
594,"ELGEYO/MARAKWET",80,272,445,717
595,"ELGEYO/MARAKWET",81,153,275,428
596,"ELGEYO/MARAKWET",82,83,136,219
597,"ELGEYO/MARAKWET",83,146,205,351
598,"ELGEYO/MARAKWET",84,133,201,334
599,"ELGEYO/MARAKWET","80-84",787,1262,2049
600,"ELGEYO/MARAKWET",85,95,152,247
601,"ELGEYO/MARAKWET",86,74,68,142
602,"ELGEYO/MARAKWET",87,90,109,199
603,"ELGEYO/MARAKWET",88,52,68,120
604,"ELGEYO/MARAKWET",89,164,272,436
605,"ELGEYO/MARAKWET","85-89",475,669,1144
606,"ELGEYO/MARAKWET",90,72,140,212
607,"ELGEYO/MARAKWET",91,42,67,109
608,"ELGEYO/MARAKWET",92,16,39,55
609,"ELGEYO/MARAKWET",93,34,38,72
610,"ELGEYO/MARAKWET",94,30,46,76
611,"ELGEYO/MARAKWET","90-94",194,330,524
612,"ELGEYO/MARAKWET",95,60,80,140
613,"ELGEYO/MARAKWET",96,12,20,32
614,"ELGEYO/MARAKWET",97,13,20,33
615,"ELGEYO/MARAKWET",98,13,18,31
616,"ELGEYO/MARAKWET",99,31,62,93
617,"ELGEYO/MARAKWET","95-99",129,200,329
618,"ELGEYO/MARAKWET","100+",43,109,152
619,"ELGEYO/MARAKWET","Not Stated","-",1,1
621,"EMBU","Total",267126,265534,532660
622,"EMBU",0,4831,4847,9678
623,"EMBU",1,5693,5384,11077
624,"EMBU",2,5332,5307,10639
625,"EMBU",3,5644,5436,11080
626,"EMBU",4,5514,5347,10861
627,"EMBU","0 - 4",27014,26321,53335
628,"EMBU",5,5384,5096,10480
629,"EMBU",6,5201,5328,10529
630,"EMBU",7,5457,5406,10863
631,"EMBU",8,5511,5295,10806
632,"EMBU",9,5992,5892,11884
633,"EMBU","5-9",27545,27017,54562
634,"EMBU",10,5966,5834,11800
635,"EMBU",11,5809,5874,11683
636,"EMBU",12,6647,6230,12877
637,"EMBU",13,6703,6567,13270
638,"EMBU",14,6429,6079,12508
639,"EMBU","10-14",31554,30584,62138
640,"EMBU",15,6292,6145,12437
641,"EMBU",16,6349,6095,12444
642,"EMBU",17,6351,5764,12115
643,"EMBU",18,5269,4750,10019
644,"EMBU",19,5453,4766,10219
645,"EMBU","15-19",29714,27520,57234
646,"EMBU",20,5150,4663,9813
647,"EMBU",21,4366,3966,8332
648,"EMBU",22,4373,4152,8525
649,"EMBU",23,4395,4272,8667
650,"EMBU",24,3999,3610,7609
651,"EMBU","20-24",22283,20663,42946
652,"EMBU",25,4215,3767,7982
653,"EMBU",26,3453,3275,6728
654,"EMBU",27,3800,3419,7219
655,"EMBU",28,3416,3179,6595
656,"EMBU",29,3779,3701,7480
657,"EMBU","25-29",18663,17341,36004
658,"EMBU",30,4605,4474,9079
659,"EMBU",31,3351,3263,6614
660,"EMBU",32,4079,4260,8339
661,"EMBU",33,3904,3938,7842
662,"EMBU",34,3344,3486,6830
663,"EMBU","30-34",19283,19421,38704
664,"EMBU",35,4722,4356,9078
665,"EMBU",36,3399,3392,6791
666,"EMBU",37,3695,3316,7011
667,"EMBU",38,3021,3005,6026
668,"EMBU",39,3542,3432,6974
669,"EMBU","35-39",18379,17501,35880
670,"EMBU",40,4126,3791,7917
671,"EMBU",41,3402,3140,6542
672,"EMBU",42,3122,3011,6133
673,"EMBU",43,2964,2926,5890
674,"EMBU",44,2692,2523,5215
675,"EMBU","40-44",16306,15391,31697
676,"EMBU",45,3509,3397,6906
677,"EMBU",46,2760,2754,5514
678,"EMBU",47,2717,2632,5349
679,"EMBU",48,2244,2208,4452
680,"EMBU",49,2458,2430,4888
681,"EMBU","45-49",13688,13421,27109
682,"EMBU",50,2690,2978,5668
683,"EMBU",51,2262,2301,4563
684,"EMBU",52,2170,2280,4450
685,"EMBU",53,1629,1890,3519
686,"EMBU",54,1918,1956,3874
687,"EMBU","50-54",10669,11405,22074
688,"EMBU",55,2219,2188,4407
689,"EMBU",56,2508,2625,5133
690,"EMBU",57,1866,2180,4046
691,"EMBU",58,1407,1591,2998
692,"EMBU",59,1781,1893,3674
693,"EMBU","55-59",9781,10477,20258
694,"EMBU",60,2058,2133,4191
695,"EMBU",61,1527,1624,3151
696,"EMBU",62,1276,1334,2610
697,"EMBU",63,1017,1174,2191
698,"EMBU",64,868,967,1835
699,"EMBU","60-64",6746,7232,13978
700,"EMBU",65,1447,1660,3107
701,"EMBU",66,1124,1076,2200
702,"EMBU",67,1721,1680,3401
703,"EMBU",68,722,806,1528
704,"EMBU",69,1014,1277,2291
705,"EMBU","65-69",6028,6499,12527
706,"EMBU",70,1232,1994,3226
707,"EMBU",71,864,1090,1954
708,"EMBU",72,676,809,1485
709,"EMBU",73,578,720,1298
710,"EMBU",74,518,784,1302
711,"EMBU","70-74",3868,5397,9265
712,"EMBU",75,520,834,1354
713,"EMBU",76,398,468,866
714,"EMBU",77,432,591,1023
715,"EMBU",78,336,364,700
716,"EMBU",79,410,733,1143
717,"EMBU","75-79",2096,2990,5086
718,"EMBU",80,582,1080,1662
719,"EMBU",81,278,541,819
720,"EMBU",82,264,283,547
721,"EMBU",83,294,354,648
722,"EMBU",84,279,448,727
723,"EMBU","80-84",1697,2706,4403
724,"EMBU",85,259,405,664
725,"EMBU",86,179,206,385
726,"EMBU",87,201,287,488
727,"EMBU",88,119,166,285
728,"EMBU",89,224,537,761
729,"EMBU","85-89",982,1601,2583
730,"EMBU",90,145,420,565
731,"EMBU",91,134,330,464
732,"EMBU",92,73,124,197
733,"EMBU",93,41,142,183
734,"EMBU",94,53,131,184
735,"EMBU","90-94",446,1147,1593
736,"EMBU",95,81,180,261
737,"EMBU",96,32,86,118
738,"EMBU",97,61,79,140
739,"EMBU",98,30,66,96
740,"EMBU",99,60,158,218
741,"EMBU","95-99",264,569,833
742,"EMBU","100+",116,328,444
743,"EMBU","Not Stated",4,3,7
745,"GARISSA","Total",349423,281013,630436
746,"GARISSA",0,4103,4097,8200
747,"GARISSA",1,5888,5772,11660
748,"GARISSA",2,10777,10349,21126
749,"GARISSA",3,9392,8910,18302
750,"GARISSA",4,11659,10664,22323
751,"GARISSA","0 - 4",41819,39792,81611
752,"GARISSA",5,10570,9541,20111
753,"GARISSA",6,12302,11014,23316
754,"GARISSA",7,8649,7729,16378
755,"GARISSA",8,13843,12034,25877
756,"GARISSA",9,8836,7831,16667
757,"GARISSA","5-9",54200,48149,102349
758,"GARISSA",10,17765,13979,31744
759,"GARISSA",11,7373,7056,14429
760,"GARISSA",12,14214,8833,23047
761,"GARISSA",13,9567,6422,15989
762,"GARISSA",14,11805,7115,18920
763,"GARISSA","10-14",60724,43405,104129
764,"GARISSA",15,14726,8666,23392
765,"GARISSA",16,11094,6746,17840
766,"GARISSA",17,10070,6325,16395
767,"GARISSA",18,11875,7939,19814
768,"GARISSA",19,6668,5081,11749
769,"GARISSA","15-19",54433,34757,89190
770,"GARISSA",20,14692,11337,26029
771,"GARISSA",21,5253,4062,9315
772,"GARISSA",22,5948,4909,10857
773,"GARISSA",23,5264,4127,9391
774,"GARISSA",24,4570,3759,8329
775,"GARISSA","20-24",35727,28194,63921
776,"GARISSA",25,9089,7998,17087
777,"GARISSA",26,4001,3363,7364
778,"GARISSA",27,3408,2773,6181
779,"GARISSA",28,4854,4694,9548
780,"GARISSA",29,3442,3270,6712
781,"GARISSA","25-29",24794,22098,46892
782,"GARISSA",30,10137,9441,19578
783,"GARISSA",31,2272,2082,4354
784,"GARISSA",32,3338,3269,6607
785,"GARISSA",33,2141,2088,4229
786,"GARISSA",34,1935,1883,3818
787,"GARISSA","30-34",19823,18763,38586
788,"GARISSA",35,5374,5620,10994
789,"GARISSA",36,2152,2244,4396
790,"GARISSA",37,1672,1784,3456
791,"GARISSA",38,2662,2866,5528
792,"GARISSA",39,1845,1872,3717
793,"GARISSA","35-39",13705,14386,28091
794,"GARISSA",40,7849,6025,13874
795,"GARISSA",41,1564,1428,2992
796,"GARISSA",42,1989,1580,3569
797,"GARISSA",43,1441,1264,2705
798,"GARISSA",44,829,655,1484
799,"GARISSA","40-44",13672,10952,24624
800,"GARISSA",45,4052,2885,6937
801,"GARISSA",46,1022,816,1838
802,"GARISSA",47,953,700,1653
803,"GARISSA",48,1334,1012,2346
804,"GARISSA",49,973,836,1809
805,"GARISSA","45-49",8334,6249,14583
806,"GARISSA",50,4706,3024,7730
807,"GARISSA",51,661,431,1092
808,"GARISSA",52,1268,835,2103
809,"GARISSA",53,596,379,975
810,"GARISSA",54,842,518,1360
811,"GARISSA","50-54",8073,5187,13260
812,"GARISSA",55,1160,786,1946
813,"GARISSA",56,742,526,1268
814,"GARISSA",57,524,353,877
815,"GARISSA",58,725,502,1227
816,"GARISSA",59,682,475,1157
817,"GARISSA","55-59",3833,2642,6475
818,"GARISSA",60,2573,1623,4196
819,"GARISSA",61,430,252,682
820,"GARISSA",62,511,266,777
821,"GARISSA",63,441,272,713
822,"GARISSA",64,301,193,494
823,"GARISSA","60-64",4256,2606,6862
824,"GARISSA",65,787,525,1312
825,"GARISSA",66,281,159,440
826,"GARISSA",67,270,193,463
827,"GARISSA",68,367,191,558
828,"GARISSA",69,357,240,597
829,"GARISSA","65-69",2062,1308,3370
830,"GARISSA",70,1219,732,1951
831,"GARISSA",71,204,173,377
832,"GARISSA",72,220,118,338
833,"GARISSA",73,175,73,248
834,"GARISSA",74,160,92,252
835,"GARISSA","70-74",1978,1188,3166
836,"GARISSA",75,273,166,439
837,"GARISSA",76,118,65,183
838,"GARISSA",77,79,45,124
839,"GARISSA",78,151,78,229
840,"GARISSA",79,153,67,220
841,"GARISSA","75-79",774,421,1195
842,"GARISSA",80,499,361,860
843,"GARISSA",81,80,64,144
844,"GARISSA",82,63,42,105
845,"GARISSA",83,51,27,78
846,"GARISSA",84,77,36,113
847,"GARISSA","80-84",770,530,1300
848,"GARISSA",85,81,70,151
849,"GARISSA",86,37,22,59
850,"GARISSA",87,30,26,56
851,"GARISSA",88,26,22,48
852,"GARISSA",89,48,26,74
853,"GARISSA","85-89",222,166,388
854,"GARISSA",90,107,111,218
855,"GARISSA",91,16,21,37
856,"GARISSA",92,9,9,18
857,"GARISSA",93,9,5,14
858,"GARISSA",94,2,8,10
859,"GARISSA","90-94",143,154,297
860,"GARISSA",95,19,14,33
861,"GARISSA",96,10,10,20
862,"GARISSA",97,3,1,4
863,"GARISSA",98,11,8,19
864,"GARISSA",99,9,5,14
865,"GARISSA","95-99",52,38,90
866,"GARISSA","100+",28,27,55
867,"GARISSA","Not Stated",1,1,2
869,"HOMA BAY","Total",485991,532861,1018852
870,"HOMA BAY",0,12506,12503,25009
871,"HOMA BAY",1,13379,12990,26369
872,"HOMA BAY",2,13964,13881,27845
873,"HOMA BAY",3,14997,15230,30227
874,"HOMA BAY",4,15274,15184,30458
875,"HOMA BAY","0 - 4",70120,69788,139908
876,"HOMA BAY",5,15585,15201,30786
877,"HOMA BAY",6,15319,15789,31108
878,"HOMA BAY",7,14837,15032,29869
879,"HOMA BAY",8,14362,14319,28681
880,"HOMA BAY",9,16147,16197,32344
881,"HOMA BAY","5-9",76250,76538,152788
882,"HOMA BAY",10,17686,17151,34837
883,"HOMA BAY",11,15595,15627,31222
884,"HOMA BAY",12,18227,17524,35751
885,"HOMA BAY",13,17187,17066,34253
886,"HOMA BAY",14,15627,15261,30888
887,"HOMA BAY","10-14",84322,82629,166951
888,"HOMA BAY",15,15414,15125,30539
889,"HOMA BAY",16,13609,13285,26894
890,"HOMA BAY",17,13241,12259,25500
891,"HOMA BAY",18,10459,9679,20138
892,"HOMA BAY",19,10782,10917,21699
893,"HOMA BAY","15-19",63505,61265,124770
894,"HOMA BAY",20,9386,10683,20069
895,"HOMA BAY",21,7931,9029,16960
896,"HOMA BAY",22,6928,8558,15486
897,"HOMA BAY",23,7363,8996,16359
898,"HOMA BAY",24,6445,7584,14029
899,"HOMA BAY","20-24",38053,44850,82903
900,"HOMA BAY",25,7543,8765,16308
901,"HOMA BAY",26,5622,7372,12994
902,"HOMA BAY",27,6032,7989,14021
903,"HOMA BAY",28,4133,5681,9814
904,"HOMA BAY",29,4223,5961,10184
905,"HOMA BAY","25-29",27553,35768,63321
906,"HOMA BAY",30,6472,9640,16112
907,"HOMA BAY",31,4565,6445,11010
908,"HOMA BAY",32,5631,8186,13817
909,"HOMA BAY",33,5044,7117,12161
910,"HOMA BAY",34,4670,5785,10455
911,"HOMA BAY","30-34",26382,37173,63555
912,"HOMA BAY",35,6067,6756,12823
913,"HOMA BAY",36,4425,4336,8761
914,"HOMA BAY",37,4538,4076,8614
915,"HOMA BAY",38,3023,2698,5721
916,"HOMA BAY",39,3808,3547,7355
917,"HOMA BAY","35-39",21861,21413,43274
918,"HOMA BAY",40,4719,5032,9751
919,"HOMA BAY",41,4116,4065,8181
920,"HOMA BAY",42,3674,3968,7642
921,"HOMA BAY",43,3524,4005,7529
922,"HOMA BAY",44,2762,3287,6049
923,"HOMA BAY","40-44",18795,20357,39152
924,"HOMA BAY",45,3788,4747,8535
925,"HOMA BAY",46,2695,3354,6049
926,"HOMA BAY",47,2842,3851,6693
927,"HOMA BAY",48,1625,2009,3634
928,"HOMA BAY",49,1878,2389,4267
929,"HOMA BAY","45-49",12828,16350,29178
930,"HOMA BAY",50,2484,3672,6156
931,"HOMA BAY",51,1951,2659,4610
932,"HOMA BAY",52,1617,2144,3761
933,"HOMA BAY",53,1431,1814,3245
934,"HOMA BAY",54,1780,2052,3832
935,"HOMA BAY","50-54",9263,12341,21604
936,"HOMA BAY",55,2110,2465,4575
937,"HOMA BAY",56,2110,3247,5357
938,"HOMA BAY",57,2123,3634,5757
939,"HOMA BAY",58,1263,1805,3068
940,"HOMA BAY",59,1742,2488,4230
941,"HOMA BAY","55-59",9348,13639,22987
942,"HOMA BAY",60,2250,3597,5847
943,"HOMA BAY",61,1994,2723,4717
944,"HOMA BAY",62,1516,1942,3458
945,"HOMA BAY",63,1566,2097,3663
946,"HOMA BAY",64,1302,1739,3041
947,"HOMA BAY","60-64",8628,12098,20726
948,"HOMA BAY",65,1768,2550,4318
949,"HOMA BAY",66,1202,1672,2874
950,"HOMA BAY",67,1904,2778,4682
951,"HOMA BAY",68,751,1011,1762
952,"HOMA BAY",69,1252,1803,3055
953,"HOMA BAY","65-69",6877,9814,16691
954,"HOMA BAY",70,1790,3094,4884
955,"HOMA BAY",71,1271,1514,2785
956,"HOMA BAY",72,1008,1227,2235
957,"HOMA BAY",73,803,1020,1823
958,"HOMA BAY",74,771,1218,1989
959,"HOMA BAY","70-74",5643,8073,13716
960,"HOMA BAY",75,668,1087,1755
961,"HOMA BAY",76,486,727,1213
962,"HOMA BAY",77,757,1091,1848
963,"HOMA BAY",78,331,523,854
964,"HOMA BAY",79,474,1049,1523
965,"HOMA BAY","75-79",2716,4477,7193
966,"HOMA BAY",80,574,1223,1797
967,"HOMA BAY",81,418,670,1088
968,"HOMA BAY",82,343,396,739
969,"HOMA BAY",83,413,518,931
970,"HOMA BAY",84,305,550,855
971,"HOMA BAY","80-84",2053,3357,5410
972,"HOMA BAY",85,258,455,713
973,"HOMA BAY",86,239,323,562
974,"HOMA BAY",87,295,451,746
975,"HOMA BAY",88,114,179,293
976,"HOMA BAY",89,227,497,724
977,"HOMA BAY","85-89",1133,1905,3038
978,"HOMA BAY",90,142,273,415
979,"HOMA BAY",91,109,129,238
980,"HOMA BAY",92,65,74,139
981,"HOMA BAY",93,47,79,126
982,"HOMA BAY",94,45,65,110
983,"HOMA BAY","90-94",408,620,1028
984,"HOMA BAY",95,49,80,129
985,"HOMA BAY",96,36,52,88
986,"HOMA BAY",97,41,46,87
987,"HOMA BAY",98,22,37,59
988,"HOMA BAY",99,32,71,103
989,"HOMA BAY","95-99",180,286,466
990,"HOMA BAY","100+",71,114,185
991,"HOMA BAY","Not Stated",2,6,8
993,"ISIOLO","Total",76435,65894,142329
994,"ISIOLO",0,1794,1749,3543
995,"ISIOLO",1,1790,1754,3544
996,"ISIOLO",2,2709,2638,5347
997,"ISIOLO",3,2505,2479,4984
998,"ISIOLO",4,2711,2633,5344
999,"ISIOLO","0 - 4",11509,11253,22762
1000,"ISIOLO",5,2684,2462,5146
1001,"ISIOLO",6,2704,2564,5268
1002,"ISIOLO",7,2275,2165,4440
1003,"ISIOLO",8,2711,2549,5260
1004,"ISIOLO",9,2010,1830,3840
1005,"ISIOLO","5-9",12384,11570,23954
1006,"ISIOLO",10,3430,3021,6451
1007,"ISIOLO",11,1715,1643,3358
1008,"ISIOLO",12,2786,2148,4934
1009,"ISIOLO",13,2059,1716,3775
1010,"ISIOLO",14,2177,1662,3839
1011,"ISIOLO","10-14",12167,10190,22357
1012,"ISIOLO",15,2681,1883,4564
1013,"ISIOLO",16,1989,1469,3458
1014,"ISIOLO",17,2153,1486,3639
1015,"ISIOLO",18,1853,1345,3198
1016,"ISIOLO",19,1005,837,1842
1017,"ISIOLO","15-19",9681,7020,16701
1018,"ISIOLO",20,2249,1876,4125
1019,"ISIOLO",21,957,862,1819
1020,"ISIOLO",22,1193,1157,2350
1021,"ISIOLO",23,1094,936,2030
1022,"ISIOLO",24,951,806,1757
1023,"ISIOLO","20-24",6444,5637,12081
1024,"ISIOLO",25,1717,1448,3165
1025,"ISIOLO",26,918,872,1790
1026,"ISIOLO",27,903,792,1695
1027,"ISIOLO",28,1010,872,1882
1028,"ISIOLO",29,748,625,1373
1029,"ISIOLO","25-29",5296,4609,9905
1030,"ISIOLO",30,1987,1584,3571
1031,"ISIOLO",31,693,704,1397
1032,"ISIOLO",32,899,819,1718
1033,"ISIOLO",33,616,600,1216
1034,"ISIOLO",34,597,569,1166
1035,"ISIOLO","30-34",4792,4276,9068
1036,"ISIOLO",35,1296,1141,2437
1037,"ISIOLO",36,583,508,1091
1038,"ISIOLO",37,475,352,827
1039,"ISIOLO",38,515,411,926
1040,"ISIOLO",39,342,273,615
1041,"ISIOLO","35-39",3211,2685,5896
1042,"ISIOLO",40,1364,895,2259
1043,"ISIOLO",41,549,534,1083
1044,"ISIOLO",42,429,288,717
1045,"ISIOLO",43,306,203,509
1046,"ISIOLO",44,168,126,294
1047,"ISIOLO","40-44",2816,2046,4862
1048,"ISIOLO",45,759,586,1345
1049,"ISIOLO",46,353,314,667
1050,"ISIOLO",47,243,230,473
1051,"ISIOLO",48,263,209,472
1052,"ISIOLO",49,239,152,391
1053,"ISIOLO","45-49",1857,1491,3348
1054,"ISIOLO",50,758,574,1332
1055,"ISIOLO",51,162,129,291
1056,"ISIOLO",52,227,187,414
1057,"ISIOLO",53,180,117,297
1058,"ISIOLO",54,236,182,418
1059,"ISIOLO","50-54",1563,1189,2752
1060,"ISIOLO",55,299,199,498
1061,"ISIOLO",56,250,188,438
1062,"ISIOLO",57,163,183,346
1063,"ISIOLO",58,189,195,384
1064,"ISIOLO",59,215,239,454
1065,"ISIOLO","55-59",1116,1004,2120
1066,"ISIOLO",60,625,434,1059
1067,"ISIOLO",61,170,178,348
1068,"ISIOLO",62,191,112,303
1069,"ISIOLO",63,190,138,328
1070,"ISIOLO",64,138,104,242
1071,"ISIOLO","60-64",1314,966,2280
1072,"ISIOLO",65,223,204,427
1073,"ISIOLO",66,101,95,196
1074,"ISIOLO",67,145,114,259
1075,"ISIOLO",68,117,76,193
1076,"ISIOLO",69,152,107,259
1077,"ISIOLO","65-69",738,596,1334
1078,"ISIOLO",70,409,305,714
1079,"ISIOLO",71,93,122,215
1080,"ISIOLO",72,79,64,143
1081,"ISIOLO",73,75,52,127
1082,"ISIOLO",74,81,54,135
1083,"ISIOLO","70-74",737,597,1334
1084,"ISIOLO",75,101,92,193
1085,"ISIOLO",76,51,54,105
1086,"ISIOLO",77,49,26,75
1087,"ISIOLO",78,60,36,96
1088,"ISIOLO",79,74,58,132
1089,"ISIOLO","75-79",335,266,601
1090,"ISIOLO",80,138,128,266
1091,"ISIOLO",81,34,69,103
1092,"ISIOLO",82,40,15,55
1093,"ISIOLO",83,21,22,43
1094,"ISIOLO",84,24,26,50
1095,"ISIOLO","80-84",257,260,517
1096,"ISIOLO",85,36,40,76
1097,"ISIOLO",86,14,11,25
1098,"ISIOLO",87,20,16,36
1099,"ISIOLO",88,17,8,25
1100,"ISIOLO",89,36,35,71
1101,"ISIOLO","85-89",123,110,233
1102,"ISIOLO",90,27,42,69
1103,"ISIOLO",91,10,14,24
1104,"ISIOLO",92,10,8,18
1105,"ISIOLO",93,4,6,10
1106,"ISIOLO",94,6,5,11
1107,"ISIOLO","90-94",57,75,132
1108,"ISIOLO",95,8,13,21
1109,"ISIOLO",96,3,5,8
1110,"ISIOLO",97,6,3,9
1111,"ISIOLO",98,3,3,6
1112,"ISIOLO",99,7,9,16
1113,"ISIOLO","95-99",27,33,60
1114,"ISIOLO","100+",11,21,32
1115,"ISIOLO","Not Stated","-","-","-"
1117,"KAJIADO","Total",250233,244970,495203
1118,"KAJIADO",0,6560,6510,13070
1119,"KAJIADO",1,7917,7569,15486
1120,"KAJIADO",2,8331,7992,16323
1121,"KAJIADO",3,9001,8678,17679
1122,"KAJIADO",4,8931,8793,17724
1123,"KAJIADO","0 - 4",40740,39542,80282
1124,"KAJIADO",5,9084,8633,17717
1125,"KAJIADO",6,8838,8777,17615
1126,"KAJIADO",7,7757,7934,15691
1127,"KAJIADO",8,8013,7690,15703
1128,"KAJIADO",9,7175,6740,13915
1129,"KAJIADO","5-9",40867,39774,80641
1130,"KAJIADO",10,8967,8593,17560
1131,"KAJIADO",11,5942,6228,12170
1132,"KAJIADO",12,7928,7670,15598
1133,"KAJIADO",13,6906,7105,14011
1134,"KAJIADO",14,6279,6421,12700
1135,"KAJIADO","10-14",36022,36017,72039
1136,"KAJIADO",15,6610,6098,12708
1137,"KAJIADO",16,5352,5146,10498
1138,"KAJIADO",17,5258,4618,9876
1139,"KAJIADO",18,4281,4299,8580
1140,"KAJIADO",19,4633,4448,9081
1141,"KAJIADO","15-19",26134,24609,50743
1142,"KAJIADO",20,4918,5296,10214
1143,"KAJIADO",21,4028,3928,7956
1144,"KAJIADO",22,3978,4172,8150
1145,"KAJIADO",23,4033,4234,8267
1146,"KAJIADO",24,3832,3734,7566
1147,"KAJIADO","20-24",20789,21364,42153
1148,"KAJIADO",25,4722,4789,9511
1149,"KAJIADO",26,3328,3618,6946
1150,"KAJIADO",27,3645,3647,7292
1151,"KAJIADO",28,3039,3183,6222
1152,"KAJIADO",29,3018,3036,6054
1153,"KAJIADO","25-29",17752,18273,36025
1154,"KAJIADO",30,4769,4955,9724
1155,"KAJIADO",31,2598,2961,5559
1156,"KAJIADO",32,3549,3721,7270
1157,"KAJIADO",33,2733,2665,5398
1158,"KAJIADO",34,2533,2142,4675
1159,"KAJIADO","30-34",16182,16444,32626
1160,"KAJIADO",35,4311,3779,8090
1161,"KAJIADO",36,2221,1876,4097
1162,"KAJIADO",37,2262,1663,3925
1163,"KAJIADO",38,1900,1322,3222
1164,"KAJIADO",39,1652,1254,2906
1165,"KAJIADO","35-39",12346,9894,22240
1166,"KAJIADO",40,2852,2486,5338
1167,"KAJIADO",41,2017,2043,4060
1168,"KAJIADO",42,2075,2258,4333
1169,"KAJIADO",43,1460,1389,2849
1170,"KAJIADO",44,1028,883,1911
1171,"KAJIADO","40-44",9432,9059,18491
1172,"KAJIADO",45,3081,2813,5894
1173,"KAJIADO",46,1730,1725,3455
1174,"KAJIADO",47,1656,1410,3066
1175,"KAJIADO",48,1109,933,2042
1176,"KAJIADO",49,1155,1026,2181
1177,"KAJIADO","45-49",8731,7907,16638
1178,"KAJIADO",50,2056,1909,3965
1179,"KAJIADO",51,1422,1482,2904
1180,"KAJIADO",52,1182,1023,2205
1181,"KAJIADO",53,764,639,1403
1182,"KAJIADO",54,1073,1160,2233
1183,"KAJIADO","50-54",6497,6213,12710
1184,"KAJIADO",55,1140,1148,2288
1185,"KAJIADO",56,966,964,1930
1186,"KAJIADO",57,719,766,1485
1187,"KAJIADO",58,671,629,1300
1188,"KAJIADO",59,777,1029,1806
1189,"KAJIADO","55-59",4273,4536,8809
1190,"KAJIADO",60,1322,1399,2721
1191,"KAJIADO",61,660,785,1445
1192,"KAJIADO",62,601,637,1238
1193,"KAJIADO",63,603,696,1299
1194,"KAJIADO",64,463,387,850
1195,"KAJIADO","60-64",3649,3904,7553
1196,"KAJIADO",65,828,833,1661
1197,"KAJIADO",66,337,340,677
1198,"KAJIADO",67,513,465,978
1199,"KAJIADO",68,301,277,578
1200,"KAJIADO",69,376,513,889
1201,"KAJIADO","65-69",2355,2428,4783
1202,"KAJIADO",70,846,901,1747
1203,"KAJIADO",71,367,425,792
1204,"KAJIADO",72,288,266,554
1205,"KAJIADO",73,224,230,454
1206,"KAJIADO",74,254,287,541
1207,"KAJIADO","70-74",1979,2109,4088
1208,"KAJIADO",75,307,330,637
1209,"KAJIADO",76,211,171,382
1210,"KAJIADO",77,186,177,363
1211,"KAJIADO",78,132,115,247
1212,"KAJIADO",79,236,291,527
1213,"KAJIADO","75-79",1072,1084,2156
1214,"KAJIADO",80,309,412,721
1215,"KAJIADO",81,114,135,249
1216,"KAJIADO",82,93,75,168
1217,"KAJIADO",83,75,100,175
1218,"KAJIADO",84,73,117,190
1219,"KAJIADO","80-84",664,839,1503
1220,"KAJIADO",85,123,137,260
1221,"KAJIADO",86,69,70,139
1222,"KAJIADO",87,63,59,122
1223,"KAJIADO",88,32,40,72
1224,"KAJIADO",89,98,134,232
1225,"KAJIADO","85-89",385,440,825
1226,"KAJIADO",90,93,128,221
1227,"KAJIADO",91,36,37,73
1228,"KAJIADO",92,19,30,49
1229,"KAJIADO",93,19,23,42
1230,"KAJIADO",94,19,22,41
1231,"KAJIADO","90-94",186,240,426
1232,"KAJIADO",95,47,65,112
1233,"KAJIADO",96,16,24,40
1234,"KAJIADO",97,14,21,35
1235,"KAJIADO",98,14,21,35
1236,"KAJIADO",99,23,31,54
1237,"KAJIADO","95-99",114,162,276
1238,"KAJIADO","100+",61,131,192
1239,"KAJIADO","Not Stated",3,1,4
1241,"KAKAMEGA","Total",806682,875526,1682208
1242,"KAKAMEGA",0,18699,18920,37619
1243,"KAKAMEGA",1,19338,19787,39125
1244,"KAKAMEGA",2,19900,20095,39995
1245,"KAKAMEGA",3,21230,21772,43002
1246,"KAKAMEGA",4,22613,22367,44980
1247,"KAKAMEGA","0 - 4",101780,102941,204721
1248,"KAKAMEGA",5,23782,23336,47118
1249,"KAKAMEGA",6,24649,24889,49538
1250,"KAKAMEGA",7,24704,24485,49189
1251,"KAKAMEGA",8,23382,24147,47529
1252,"KAKAMEGA",9,26954,26787,53741
1253,"KAKAMEGA","5-9",123471,123644,247115
1254,"KAKAMEGA",10,27500,27104,54604
1255,"KAKAMEGA",11,25196,26245,51441
1256,"KAKAMEGA",12,28508,27932,56440
1257,"KAKAMEGA",13,27375,28194,55569
1258,"KAKAMEGA",14,25627,25808,51435
1259,"KAKAMEGA","10-14",134206,135283,269489
1260,"KAKAMEGA",15,25124,25411,50535
1261,"KAKAMEGA",16,23326,23472,46798
1262,"KAKAMEGA",17,23774,22808,46582
1263,"KAKAMEGA",18,19179,17641,36820
1264,"KAKAMEGA",19,18990,18472,37462
1265,"KAKAMEGA","15-19",110393,107804,218197
1266,"KAKAMEGA",20,16021,16797,32818
1267,"KAKAMEGA",21,12946,13857,26803
1268,"KAKAMEGA",22,11407,12573,23980
1269,"KAKAMEGA",23,10828,13119,23947
1270,"KAKAMEGA",24,9168,11515,20683
1271,"KAKAMEGA","20-24",60370,67861,128231
1272,"KAKAMEGA",25,10131,12483,22614
1273,"KAKAMEGA",26,8333,11289,19622
1274,"KAKAMEGA",27,8766,11493,20259
1275,"KAKAMEGA",28,6950,9120,16070
1276,"KAKAMEGA",29,7639,10270,17909
1277,"KAKAMEGA","25-29",41819,54655,96474
1278,"KAKAMEGA",30,9605,13505,23110
1279,"KAKAMEGA",31,7946,10479,18425
1280,"KAKAMEGA",32,9681,13147,22828
1281,"KAKAMEGA",33,8293,11306,19599
1282,"KAKAMEGA",34,7623,9365,16988
1283,"KAKAMEGA","30-34",43148,57802,100950
1284,"KAKAMEGA",35,8918,10181,19099
1285,"KAKAMEGA",36,7028,7484,14512
1286,"KAKAMEGA",37,7627,7444,15071
1287,"KAKAMEGA",38,5567,5695,11262
1288,"KAKAMEGA",39,6405,6618,13023
1289,"KAKAMEGA","35-39",35545,37422,72967
1290,"KAKAMEGA",40,7276,8240,15516
1291,"KAKAMEGA",41,7000,7975,14975
1292,"KAKAMEGA",42,7151,8057,15208
1293,"KAKAMEGA",43,6532,7769,14301
1294,"KAKAMEGA",44,5438,6232,11670
1295,"KAKAMEGA","40-44",33397,38273,71670
1296,"KAKAMEGA",45,7011,8137,15148
1297,"KAKAMEGA",46,5462,6155,11617
1298,"KAKAMEGA",47,5821,6342,12163
1299,"KAKAMEGA",48,4075,4434,8509
1300,"KAKAMEGA",49,4596,5196,9792
1301,"KAKAMEGA","45-49",26965,30264,57229
1302,"KAKAMEGA",50,5456,7261,12717
1303,"KAKAMEGA",51,4897,6131,11028
1304,"KAKAMEGA",52,4050,4726,8776
1305,"KAKAMEGA",53,3558,4553,8111
1306,"KAKAMEGA",54,3852,4426,8278
1307,"KAKAMEGA","50-54",21813,27097,48910
1308,"KAKAMEGA",55,4301,4838,9139
1309,"KAKAMEGA",56,4213,5052,9265
1310,"KAKAMEGA",57,4442,6457,10899
1311,"KAKAMEGA",58,3246,3915,7161
1312,"KAKAMEGA",59,4226,5087,9313
1313,"KAKAMEGA","55-59",20428,25349,45777
1314,"KAKAMEGA",60,4372,5534,9906
1315,"KAKAMEGA",61,3868,4600,8468
1316,"KAKAMEGA",62,3307,3769,7076
1317,"KAKAMEGA",63,3516,4360,7876
1318,"KAKAMEGA",64,2809,3245,6054
1319,"KAKAMEGA","60-64",17872,21508,39380
1320,"KAKAMEGA",65,3548,4308,7856
1321,"KAKAMEGA",66,2417,2879,5296
1322,"KAKAMEGA",67,3397,4298,7695
1323,"KAKAMEGA",68,1610,1743,3353
1324,"KAKAMEGA",69,2487,2998,5485
1325,"KAKAMEGA","65-69",13459,16226,29685
1326,"KAKAMEGA",70,2932,3739,6671
1327,"KAKAMEGA",71,2046,2396,4442
1328,"KAKAMEGA",72,1814,1884,3698
1329,"KAKAMEGA",73,1646,1806,3452
1330,"KAKAMEGA",74,1440,1790,3230
1331,"KAKAMEGA","70-74",9878,11615,21493
1332,"KAKAMEGA",75,1313,1835,3148
1333,"KAKAMEGA",76,1347,2215,3562
1334,"KAKAMEGA",77,1176,1774,2950
1335,"KAKAMEGA",78,682,838,1520
1336,"KAKAMEGA",79,836,1367,2203
1337,"KAKAMEGA","75-79",5354,8029,13383
1338,"KAKAMEGA",80,995,1463,2458
1339,"KAKAMEGA",81,750,988,1738
1340,"KAKAMEGA",82,661,850,1511
1341,"KAKAMEGA",83,784,1018,1802
1342,"KAKAMEGA",84,508,691,1199
1343,"KAKAMEGA","80-84",3698,5010,8708
1344,"KAKAMEGA",85,541,701,1242
1345,"KAKAMEGA",86,397,610,1007
1346,"KAKAMEGA",87,545,871,1416
1347,"KAKAMEGA",88,220,310,530
1348,"KAKAMEGA",89,317,637,954
1349,"KAKAMEGA","85-89",2020,3129,5149
1350,"KAKAMEGA",90,215,284,499
1351,"KAKAMEGA",91,191,216,407
1352,"KAKAMEGA",92,125,163,288
1353,"KAKAMEGA",93,130,150,280
1354,"KAKAMEGA",94,60,116,176
1355,"KAKAMEGA","90-94",721,929,1650
1356,"KAKAMEGA",95,110,191,301
1357,"KAKAMEGA",96,43,82,125
1358,"KAKAMEGA",97,74,113,187
1359,"KAKAMEGA",98,31,49,80
1360,"KAKAMEGA",99,29,87,116
1361,"KAKAMEGA","95-99",287,522,809
1362,"KAKAMEGA","100+",45,150,195
1363,"KAKAMEGA","Not Stated",13,13,26
1365,"KERICHO","Total",402717,405500,808217
1366,"KERICHO",0,8777,8768,17545
1367,"KERICHO",1,9603,9388,18991
1368,"KERICHO",2,9985,9708,19693
1369,"KERICHO",3,10550,10499,21049
1370,"KERICHO",4,10793,10460,21253
1371,"KERICHO","0 - 4",49708,48823,98531
1372,"KERICHO",5,10794,10516,21310
1373,"KERICHO",6,10739,10576,21315
1374,"KERICHO",7,11098,10784,21882
1375,"KERICHO",8,10362,10103,20465
1376,"KERICHO",9,11963,11676,23639
1377,"KERICHO","5-9",54956,53655,108611
1378,"KERICHO",10,11684,11362,23046
1379,"KERICHO",11,11154,11070,22224
1380,"KERICHO",12,12856,12237,25093
1381,"KERICHO",13,11790,12234,24024
1382,"KERICHO",14,11664,11646,23310
1383,"KERICHO","10-14",59148,58549,117697
1384,"KERICHO",15,11583,11242,22825
1385,"KERICHO",16,10403,10155,20558
1386,"KERICHO",17,10349,9770,20119
1387,"KERICHO",18,8234,7879,16113
1388,"KERICHO",19,9786,9299,19085
1389,"KERICHO","15-19",50355,48345,98700
1390,"KERICHO",20,7613,8109,15722
1391,"KERICHO",21,7613,8052,15665
1392,"KERICHO",22,6768,7329,14097
1393,"KERICHO",23,7016,7922,14938
1394,"KERICHO",24,6189,6692,12881
1395,"KERICHO","20-24",35199,38104,73303
1396,"KERICHO",25,6924,7434,14358
1397,"KERICHO",26,5653,6484,12137
1398,"KERICHO",27,6324,6937,13261
1399,"KERICHO",28,4591,5252,9843
1400,"KERICHO",29,5490,6124,11614
1401,"KERICHO","25-29",28982,32231,61213
1402,"KERICHO",30,6346,7508,13854
1403,"KERICHO",31,5225,5956,11181
1404,"KERICHO",32,6154,7131,13285
1405,"KERICHO",33,5422,6315,11737
1406,"KERICHO",34,4755,5221,9976
1407,"KERICHO","30-34",27902,32131,60033
1408,"KERICHO",35,6137,5555,11692
1409,"KERICHO",36,4028,3073,7101
1410,"KERICHO",37,4368,3360,7728
1411,"KERICHO",38,2690,2148,4838
1412,"KERICHO",39,3877,3119,6996
1413,"KERICHO","35-39",21100,17255,38355
1414,"KERICHO",40,4102,3570,7672
1415,"KERICHO",41,5199,4417,9616
1416,"KERICHO",42,3806,3375,7181
1417,"KERICHO",43,3106,3258,6364
1418,"KERICHO",44,2466,2489,4955
1419,"KERICHO","40-44",18679,17109,35788
1420,"KERICHO",45,5453,4553,10006
1421,"KERICHO",46,2985,3017,6002
1422,"KERICHO",47,3334,3481,6815
1423,"KERICHO",48,1809,1767,3576
1424,"KERICHO",49,2459,2519,4978
1425,"KERICHO","45-49",16040,15337,31377
1426,"KERICHO",50,2688,2906,5594
1427,"KERICHO",51,2494,2469,4963
1428,"KERICHO",52,1649,1604,3253
1429,"KERICHO",53,1292,1191,2483
1430,"KERICHO",54,1382,1342,2724
1431,"KERICHO","50-54",9505,9512,19017
1432,"KERICHO",55,1494,1413,2907
1433,"KERICHO",56,1439,1600,3039
1434,"KERICHO",57,1776,2117,3893
1435,"KERICHO",58,2444,3063,5507
1436,"KERICHO",59,1903,1889,3792
1437,"KERICHO","55-59",9056,10082,19138
1438,"KERICHO",60,2037,2236,4273
1439,"KERICHO",61,1633,1661,3294
1440,"KERICHO",62,1261,1295,2556
1441,"KERICHO",63,1315,1367,2682
1442,"KERICHO",64,910,1051,1961
1443,"KERICHO","60-64",7156,7610,14766
1444,"KERICHO",65,1633,1705,3338
1445,"KERICHO",66,937,782,1719
1446,"KERICHO",67,1519,1490,3009
1447,"KERICHO",68,629,637,1266
1448,"KERICHO",69,1027,1013,2040
1449,"KERICHO","65-69",5745,5627,11372
1450,"KERICHO",70,1308,1555,2863
1451,"KERICHO",71,1209,899,2108
1452,"KERICHO",72,791,531,1322
1453,"KERICHO",73,618,585,1203
1454,"KERICHO",74,624,664,1288
1455,"KERICHO","70-74",4550,4234,8784
1456,"KERICHO",75,448,611,1059
1457,"KERICHO",76,347,385,732
1458,"KERICHO",77,515,480,995
1459,"KERICHO",78,246,266,512
1460,"KERICHO",79,380,683,1063
1461,"KERICHO","75-79",1936,2425,4361
1462,"KERICHO",80,390,770,1160
1463,"KERICHO",81,236,413,649
1464,"KERICHO",82,230,237,467
1465,"KERICHO",83,232,297,529
1466,"KERICHO",84,227,399,626
1467,"KERICHO","80-84",1315,2116,3431
1468,"KERICHO",85,206,291,497
1469,"KERICHO",86,146,148,294
1470,"KERICHO",87,170,199,369
1471,"KERICHO",88,103,130,233
1472,"KERICHO",89,178,486,664
1473,"KERICHO","85-89",803,1254,2057
1474,"KERICHO",90,115,223,338
1475,"KERICHO",91,53,112,165
1476,"KERICHO",92,44,69,113
1477,"KERICHO",93,47,64,111
1478,"KERICHO",94,47,116,163
1479,"KERICHO","90-94",306,584,890
1480,"KERICHO",95,91,130,221
1481,"KERICHO",96,29,49,78
1482,"KERICHO",97,34,53,87
1483,"KERICHO",98,17,42,59
1484,"KERICHO",99,34,93,127
1485,"KERICHO","95-99",205,367,572
1486,"KERICHO","100+",64,147,211
1487,"KERICHO","Not Stated",7,3,10
1489,"KIAMBU","Total",355557,355866,711423
1490,"KIAMBU",0,7276,7406,14682
1491,"KIAMBU",1,7404,7209,14613
1492,"KIAMBU",2,7363,7360,14723
1493,"KIAMBU",3,7652,7552,15204
1494,"KIAMBU",4,7634,7383,15017
1495,"KIAMBU","0 - 4",37329,36910,74239
1496,"KIAMBU",5,7306,7053,14359
1497,"KIAMBU",6,7180,7296,14476
1498,"KIAMBU",7,7618,7459,15077
1499,"KIAMBU",8,7229,7168,14397
1500,"KIAMBU",9,8368,8265,16633
1501,"KIAMBU","5-9",37701,37241,74942
1502,"KIAMBU",10,8099,7877,15976
1503,"KIAMBU",11,7315,7399,14714
1504,"KIAMBU",12,8188,8024,16212
1505,"KIAMBU",13,8370,8140,16510
1506,"KIAMBU",14,7949,7810,15759
1507,"KIAMBU","10-14",39921,39250,79171
1508,"KIAMBU",15,7979,7694,15673
1509,"KIAMBU",16,7827,7617,15444
1510,"KIAMBU",17,8534,7446,15980
1511,"KIAMBU",18,6697,6202,12899
1512,"KIAMBU",19,7026,6294,13320
1513,"KIAMBU","15-19",38063,35253,73316
1514,"KIAMBU",20,6281,5954,12235
1515,"KIAMBU",21,6150,5511,11661
1516,"KIAMBU",22,5950,5474,11424
1517,"KIAMBU",23,6157,5708,11865
1518,"KIAMBU",24,5406,5043,10449
1519,"KIAMBU","20-24",29944,27690,57634
1520,"KIAMBU",25,5320,4927,10247
1521,"KIAMBU",26,4716,4611,9327
1522,"KIAMBU",27,5110,4697,9807
1523,"KIAMBU",28,4350,4286,8636
1524,"KIAMBU",29,4791,4959,9750
1525,"KIAMBU","25-29",24287,23480,47767
1526,"KIAMBU",30,5643,5800,11443
1527,"KIAMBU",31,4383,4400,8783
1528,"KIAMBU",32,5419,5430,10849
1529,"KIAMBU",33,4655,4978,9633
1530,"KIAMBU",34,4541,4727,9268
1531,"KIAMBU","30-34",24641,25335,49976
1532,"KIAMBU",35,5764,5868,11632
1533,"KIAMBU",36,4536,4710,9246
1534,"KIAMBU",37,4904,4572,9476
1535,"KIAMBU",38,4168,4212,8380
1536,"KIAMBU",39,4605,4663,9268
1537,"KIAMBU","35-39",23977,24025,48002
1538,"KIAMBU",40,5083,5152,10235
1539,"KIAMBU",41,4798,4514,9312
1540,"KIAMBU",42,4492,4407,8899
1541,"KIAMBU",43,4117,4103,8220
1542,"KIAMBU",44,3593,3425,7018
1543,"KIAMBU","40-44",22083,21601,43684
1544,"KIAMBU",45,4941,4766,9707
1545,"KIAMBU",46,4034,3875,7909
1546,"KIAMBU",47,4115,3946,8061
1547,"KIAMBU",48,3095,2999,6094
1548,"KIAMBU",49,3415,3360,6775
1549,"KIAMBU","45-49",19600,18946,38546
1550,"KIAMBU",50,3655,4036,7691
1551,"KIAMBU",51,3045,3025,6070
1552,"KIAMBU",52,3350,3354,6704
1553,"KIAMBU",53,2364,2338,4702
1554,"KIAMBU",54,2846,2890,5736
1555,"KIAMBU","50-54",15260,15643,30903
1556,"KIAMBU",55,3004,2789,5793
1557,"KIAMBU",56,3195,3033,6228
1558,"KIAMBU",57,2510,2901,5411
1559,"KIAMBU",58,2055,2181,4236
1560,"KIAMBU",59,2220,2386,4606
1561,"KIAMBU","55-59",12984,13290,26274
1562,"KIAMBU",60,2458,2600,5058
1563,"KIAMBU",61,1998,2167,4165
1564,"KIAMBU",62,1804,1756,3560
1565,"KIAMBU",63,1556,1553,3109
1566,"KIAMBU",64,1181,1333,2514
1567,"KIAMBU","60-64",8997,9409,18406
1568,"KIAMBU",65,1814,1893,3707
1569,"KIAMBU",66,1287,1362,2649
1570,"KIAMBU",67,2120,2285,4405
1571,"KIAMBU",68,922,994,1916
1572,"KIAMBU",69,1392,1565,2957
1573,"KIAMBU","65-69",7535,8099,15634
1574,"KIAMBU",70,1670,2128,3798
1575,"KIAMBU",71,1276,1419,2695
1576,"KIAMBU",72,1312,1221,2533
1577,"KIAMBU",73,1032,1089,2121
1578,"KIAMBU",74,911,1091,2002
1579,"KIAMBU","70-74",6201,6948,13149
1580,"KIAMBU",75,717,1113,1830
1581,"KIAMBU",76,837,1560,2397
1582,"KIAMBU",77,657,892,1549
1583,"KIAMBU",78,386,579,965
1584,"KIAMBU",79,487,884,1371
1585,"KIAMBU","75-79",3084,5028,8112
1586,"KIAMBU",80,588,1226,1814
1587,"KIAMBU",81,360,591,951
1588,"KIAMBU",82,352,452,804
1589,"KIAMBU",83,405,550,955
1590,"KIAMBU",84,363,633,996
1591,"KIAMBU","80-84",2068,3452,5520
1592,"KIAMBU",85,285,655,940
1593,"KIAMBU",86,241,449,690
1594,"KIAMBU",87,249,337,586
1595,"KIAMBU",88,137,236,373
1596,"KIAMBU",89,234,547,781
1597,"KIAMBU","85-89",1146,2224,3370
1598,"KIAMBU",90,118,335,453
1599,"KIAMBU",91,131,221,352
1600,"KIAMBU",92,81,158,239
1601,"KIAMBU",93,66,164,230
1602,"KIAMBU",94,34,150,184
1603,"KIAMBU","90-94",430,1028,1458
1604,"KIAMBU",95,63,178,241
1605,"KIAMBU",96,42,134,176
1606,"KIAMBU",97,74,127,201
1607,"KIAMBU",98,24,72,96
1608,"KIAMBU",99,32,146,178
1609,"KIAMBU","95-99",235,657,892
1610,"KIAMBU","100+",61,352,413
1611,"KIAMBU","Not Stated",10,5,15
1613,"KILIFI","Total",512765,547115,1059880
1614,"KILIFI",0,13702,13741,27443
1615,"KILIFI",1,14789,14475,29264
1616,"KILIFI",2,15309,15168,30477
1617,"KILIFI",3,15661,15691,31352
1618,"KILIFI",4,16404,16093,32497
1619,"KILIFI","0 - 4",75865,75168,151033
1620,"KILIFI",5,17086,16873,33959
1621,"KILIFI",6,16436,16295,32731
1622,"KILIFI",7,15688,14980,30668
1623,"KILIFI",8,15794,15606,31400
1624,"KILIFI",9,16177,15950,32127
1625,"KILIFI","5-9",81181,79704,160885
1626,"KILIFI",10,17028,16672,33700
1627,"KILIFI",11,16006,16182,32188
1628,"KILIFI",12,16987,16636,33623
1629,"KILIFI",13,16829,16856,33685
1630,"KILIFI",14,15629,14999,30628
1631,"KILIFI","10-14",82479,81345,163824
1632,"KILIFI",15,15132,14732,29864
1633,"KILIFI",16,14060,13954,28014
1634,"KILIFI",17,14498,13198,27696
1635,"KILIFI",18,12540,11529,24069
1636,"KILIFI",19,12713,11938,24651
1637,"KILIFI","15-19",68943,65351,134294
1638,"KILIFI",20,11460,11532,22992
1639,"KILIFI",21,8752,8817,17569
1640,"KILIFI",22,8431,9165,17596
1641,"KILIFI",23,8168,9090,17258
1642,"KILIFI",24,6935,7813,14748
1643,"KILIFI","20-24",43746,46417,90163
1644,"KILIFI",25,7854,8454,16308
1645,"KILIFI",26,6503,7685,14188
1646,"KILIFI",27,6307,7358,13665
1647,"KILIFI",28,5337,6640,11977
1648,"KILIFI",29,5220,6636,11856
1649,"KILIFI","25-29",31221,36773,67994
1650,"KILIFI",30,6341,8470,14811
1651,"KILIFI",31,4485,6483,10968
1652,"KILIFI",32,5306,7633,12939
1653,"KILIFI",33,4423,6447,10870
1654,"KILIFI",34,4313,6455,10768
1655,"KILIFI","30-34",24868,35488,60356
1656,"KILIFI",35,5507,6473,11980
1657,"KILIFI",36,3679,4122,7801
1658,"KILIFI",37,3788,3726,7514
1659,"KILIFI",38,2633,2724,5357
1660,"KILIFI",39,3194,3006,6200
1661,"KILIFI","35-39",18801,20051,38852
1662,"KILIFI",40,4025,3917,7942
1663,"KILIFI",41,4575,6005,10580
1664,"KILIFI",42,3933,5622,9555
1665,"KILIFI",43,3185,4574,7759
1666,"KILIFI",44,2920,3333,6253
1667,"KILIFI","40-44",18638,23451,42089
1668,"KILIFI",45,4551,4754,9305
1669,"KILIFI",46,2915,3082,5997
1670,"KILIFI",47,3247,3097,6344
1671,"KILIFI",48,2263,2183,4446
1672,"KILIFI",49,2604,2508,5112
1673,"KILIFI","45-49",15580,15624,31204
1674,"KILIFI",50,3634,4973,8607
1675,"KILIFI",51,2665,3191,5856
1676,"KILIFI",52,2184,2420,4604
1677,"KILIFI",53,1658,1450,3108
1678,"KILIFI",54,1832,1448,3280
1679,"KILIFI","50-54",11973,13482,25455
1680,"KILIFI",55,1854,1317,3171
1681,"KILIFI",56,2377,2238,4615
1682,"KILIFI",57,2231,2529,4760
1683,"KILIFI",58,1827,2199,4026
1684,"KILIFI",59,2073,3801,5874
1685,"KILIFI","55-59",10362,12084,22446
1686,"KILIFI",60,2416,4524,6940
1687,"KILIFI",61,1754,3152,4906
1688,"KILIFI",62,1637,2504,4141
1689,"KILIFI",63,1737,2931,4668
1690,"KILIFI",64,1482,1867,3349
1691,"KILIFI","60-64",9026,14978,24004
1692,"KILIFI",65,2169,2876,5045
1693,"KILIFI",66,1477,1232,2709
1694,"KILIFI",67,1931,1877,3808
1695,"KILIFI",68,1004,1021,2025
1696,"KILIFI",69,1524,2625,4149
1697,"KILIFI","65-69",8105,9631,17736
1698,"KILIFI",70,1627,2954,4581
1699,"KILIFI",71,1185,1531,2716
1700,"KILIFI",72,888,960,1848
1701,"KILIFI",73,774,944,1718
1702,"KILIFI",74,919,1174,2093
1703,"KILIFI","70-74",5393,7563,12956
1704,"KILIFI",75,941,1421,2362
1705,"KILIFI",76,526,621,1147
1706,"KILIFI",77,644,690,1334
1707,"KILIFI",78,371,384,755
1708,"KILIFI",79,689,1177,1866
1709,"KILIFI","75-79",3171,4293,7464
1710,"KILIFI",80,596,1188,1784
1711,"KILIFI",81,326,523,849
1712,"KILIFI",82,245,313,558
1713,"KILIFI",83,278,389,667
1714,"KILIFI",84,281,435,716
1715,"KILIFI","80-84",1726,2848,4574
1716,"KILIFI",85,250,466,716
1717,"KILIFI",86,128,159,287
1718,"KILIFI",87,226,347,573
1719,"KILIFI",88,101,118,219
1720,"KILIFI",89,297,563,860
1721,"KILIFI","85-89",1002,1653,2655
1722,"KILIFI",90,128,281,409
1723,"KILIFI",91,87,120,207
1724,"KILIFI",92,44,77,121
1725,"KILIFI",93,45,74,119
1726,"KILIFI",94,55,78,133
1727,"KILIFI","90-94",359,630,989
1728,"KILIFI",95,58,125,183
1729,"KILIFI",96,30,41,71
1730,"KILIFI",97,39,31,70
1731,"KILIFI",98,30,41,71
1732,"KILIFI",99,64,128,192
1733,"KILIFI","95-99",221,366,587
1734,"KILIFI","100+",102,211,313
1735,"KILIFI","Not Stated",3,4,7
1737,"KIRINYAGA","Total",237086,237083,474169
1738,"KIRINYAGA",0,4433,4306,8739
1739,"KIRINYAGA",1,4184,4202,8386
1740,"KIRINYAGA",2,4233,4208,8441
1741,"KIRINYAGA",3,4443,4503,8946
1742,"KIRINYAGA",4,4317,4415,8732
1743,"KIRINYAGA","0 - 4",21610,21634,43244
1744,"KIRINYAGA",5,4377,4216,8593
1745,"KIRINYAGA",6,4222,4304,8526
1746,"KIRINYAGA",7,4584,4575,9159
1747,"KIRINYAGA",8,4423,4351,8774
1748,"KIRINYAGA",9,4900,4805,9705
1749,"KIRINYAGA","5-9",22506,22251,44757
1750,"KIRINYAGA",10,4796,4728,9524
1751,"KIRINYAGA",11,4542,4594,9136
1752,"KIRINYAGA",12,5070,4795,9865
1753,"KIRINYAGA",13,5228,5021,10249
1754,"KIRINYAGA",14,4937,4846,9783
1755,"KIRINYAGA","10-14",24573,23984,48557
1756,"KIRINYAGA",15,5085,4992,10077
1757,"KIRINYAGA",16,5066,4850,9916
1758,"KIRINYAGA",17,5154,4742,9896
1759,"KIRINYAGA",18,4368,3842,8210
1760,"KIRINYAGA",19,4290,3804,8094
1761,"KIRINYAGA","15-19",23963,22230,46193
1762,"KIRINYAGA",20,3770,3578,7348
1763,"KIRINYAGA",21,3386,3122,6508
1764,"KIRINYAGA",22,3459,3252,6711
1765,"KIRINYAGA",23,3386,3377,6763
1766,"KIRINYAGA",24,3166,2961,6127
1767,"KIRINYAGA","20-24",17167,16290,33457
1768,"KIRINYAGA",25,3387,3060,6447
1769,"KIRINYAGA",26,2677,2694,5371
1770,"KIRINYAGA",27,2919,2855,5774
1771,"KIRINYAGA",28,2720,2681,5401
1772,"KIRINYAGA",29,2970,3022,5992
1773,"KIRINYAGA","25-29",14673,14312,28985
1774,"KIRINYAGA",30,4052,4032,8084
1775,"KIRINYAGA",31,3013,3047,6060
1776,"KIRINYAGA",32,3877,4044,7921
1777,"KIRINYAGA",33,3717,3826,7543
1778,"KIRINYAGA",34,3288,3422,6710
1779,"KIRINYAGA","30-34",17947,18371,36318
1780,"KIRINYAGA",35,4743,4562,9305
1781,"KIRINYAGA",36,3595,3456,7051
1782,"KIRINYAGA",37,3795,3431,7226
1783,"KIRINYAGA",38,3220,3274,6494
1784,"KIRINYAGA",39,3658,3585,7243
1785,"KIRINYAGA","35-39",19011,18308,37319
1786,"KIRINYAGA",40,4264,4120,8384
1787,"KIRINYAGA",41,3517,3272,6789
1788,"KIRINYAGA",42,3337,3213,6550
1789,"KIRINYAGA",43,3049,2937,5986
1790,"KIRINYAGA",44,2937,2718,5655
1791,"KIRINYAGA","40-44",17104,16260,33364
1792,"KIRINYAGA",45,3798,3748,7546
1793,"KIRINYAGA",46,2927,2752,5679
1794,"KIRINYAGA",47,3010,2664,5674
1795,"KIRINYAGA",48,2360,2272,4632
1796,"KIRINYAGA",49,2583,2533,5116
1797,"KIRINYAGA","45-49",14678,13969,28647
1798,"KIRINYAGA",50,3202,3264,6466
1799,"KIRINYAGA",51,2538,2371,4909
1800,"KIRINYAGA",52,2412,2296,4708
1801,"KIRINYAGA",53,1807,1947,3754
1802,"KIRINYAGA",54,2234,1997,4231
1803,"KIRINYAGA","50-54",12193,11875,24068
1804,"KIRINYAGA",55,2377,2293,4670
1805,"KIRINYAGA",56,2540,2367,4907
1806,"KIRINYAGA",57,1863,2092,3955
1807,"KIRINYAGA",58,1620,1639,3259
1808,"KIRINYAGA",59,1914,1989,3903
1809,"KIRINYAGA","55-59",10314,10380,20694
1810,"KIRINYAGA",60,1991,2069,4060
1811,"KIRINYAGA",61,1560,1563,3123
1812,"KIRINYAGA",62,1310,1190,2500
1813,"KIRINYAGA",63,1112,1196,2308
1814,"KIRINYAGA",64,743,772,1515
1815,"KIRINYAGA","60-64",6716,6790,13506
1816,"KIRINYAGA",65,1313,1643,2956
1817,"KIRINYAGA",66,897,902,1799
1818,"KIRINYAGA",67,1539,1657,3196
1819,"KIRINYAGA",68,830,779,1609
1820,"KIRINYAGA",69,1035,1205,2240
1821,"KIRINYAGA","65-69",5614,6186,11800
1822,"KIRINYAGA",70,1258,2022,3280
1823,"KIRINYAGA",71,868,1179,2047
1824,"KIRINYAGA",72,783,769,1552
1825,"KIRINYAGA",73,616,622,1238
1826,"KIRINYAGA",74,588,773,1361
1827,"KIRINYAGA","70-74",4113,5365,9478
1828,"KIRINYAGA",75,483,748,1231
1829,"KIRINYAGA",76,392,553,945
1830,"KIRINYAGA",77,442,539,981
1831,"KIRINYAGA",78,322,324,646
1832,"KIRINYAGA",79,367,658,1025
1833,"KIRINYAGA","75-79",2006,2822,4828
1834,"KIRINYAGA",80,528,1052,1580
1835,"KIRINYAGA",81,206,466,672
1836,"KIRINYAGA",82,204,268,472
1837,"KIRINYAGA",83,226,324,550
1838,"KIRINYAGA",84,223,424,647
1839,"KIRINYAGA","80-84",1387,2534,3921
1840,"KIRINYAGA",85,208,364,572
1841,"KIRINYAGA",86,161,218,379
1842,"KIRINYAGA",87,155,207,362
1843,"KIRINYAGA",88,90,128,218
1844,"KIRINYAGA",89,182,516,698
1845,"KIRINYAGA","85-89",796,1433,2229
1846,"KIRINYAGA",90,125,382,507
1847,"KIRINYAGA",91,142,346,488
1848,"KIRINYAGA",92,50,119,169
1849,"KIRINYAGA",93,55,114,169
1850,"KIRINYAGA",94,43,129,172
1851,"KIRINYAGA","90-94",415,1090,1505
1852,"KIRINYAGA",95,54,185,239
1853,"KIRINYAGA",96,35,76,111
1854,"KIRINYAGA",97,41,74,115
1855,"KIRINYAGA",98,25,47,72
1856,"KIRINYAGA",99,36,171,207
1857,"KIRINYAGA","95-99",191,553,744
1858,"KIRINYAGA","100+",105,441,546
1859,"KIRINYAGA","Not Stated",4,5,9
1861,"KISII","Total",531860,583560,1115420
1862,"KISII",0,11522,11642,23164
1863,"KISII",1,11809,11607,23416
1864,"KISII",2,12204,12158,24362
1865,"KISII",3,13312,13504,26816
1866,"KISII",4,14058,13984,28042
1867,"KISII","0 - 4",62905,62895,125800
1868,"KISII",5,14197,14245,28442
1869,"KISII",6,15309,15421,30730
1870,"KISII",7,15978,15594,31572
1871,"KISII",8,15188,15288,30476
1872,"KISII",9,17168,16964,34132
1873,"KISII","5-9",77840,77512,155352
1874,"KISII",10,18950,18542,37492
1875,"KISII",11,16120,16773,32893
1876,"KISII",12,19684,18450,38134
1877,"KISII",13,18283,18334,36617
1878,"KISII",14,16611,16319,32930
1879,"KISII","10-14",89648,88418,178066
1880,"KISII",15,15888,15767,31655
1881,"KISII",16,14318,14097,28415
1882,"KISII",17,14464,13907,28371
1883,"KISII",18,11605,11229,22834
1884,"KISII",19,11755,11776,23531
1885,"KISII","15-19",68030,66776,134806
1886,"KISII",20,9458,10778,20236
1887,"KISII",21,7444,9047,16491
1888,"KISII",22,7172,8773,15945
1889,"KISII",23,6993,9293,16286
1890,"KISII",24,6310,8480,14790
1891,"KISII","20-24",37377,46371,83748
1892,"KISII",25,7664,10396,18060
1893,"KISII",26,6137,8391,14528
1894,"KISII",27,6563,8661,15224
1895,"KISII",28,5160,6969,12129
1896,"KISII",29,5470,7730,13200
1897,"KISII","25-29",30994,42147,73141
1898,"KISII",30,7553,11217,18770
1899,"KISII",31,6122,8713,14835
1900,"KISII",32,7136,10233,17369
1901,"KISII",33,5989,9166,15155
1902,"KISII",34,5228,7548,12776
1903,"KISII","30-34",32028,46877,78905
1904,"KISII",35,7082,8301,15383
1905,"KISII",36,4746,4647,9393
1906,"KISII",37,5078,4826,9904
1907,"KISII",38,3589,3595,7184
1908,"KISII",39,4529,4760,9289
1909,"KISII","35-39",25024,26129,51153
1910,"KISII",40,5444,5647,11091
1911,"KISII",41,5936,5560,11496
1912,"KISII",42,4394,4365,8759
1913,"KISII",43,4208,4489,8697
1914,"KISII",44,3025,3604,6629
1915,"KISII","40-44",23007,23665,46672
1916,"KISII",45,5661,6706,12367
1917,"KISII",46,3757,5023,8780
1918,"KISII",47,4132,5617,9749
1919,"KISII",48,2371,2881,5252
1920,"KISII",49,2836,3899,6735
1921,"KISII","45-49",18757,24126,42883
1922,"KISII",50,3681,4407,8088
1923,"KISII",51,3159,3161,6320
1924,"KISII",52,2249,2062,4311
1925,"KISII",53,1784,1599,3383
1926,"KISII",54,2270,1947,4217
1927,"KISII","50-54",13143,13176,26319
1928,"KISII",55,3017,2751,5768
1929,"KISII",56,3438,3575,7013
1930,"KISII",57,3775,5120,8895
1931,"KISII",58,2559,3045,5604
1932,"KISII",59,3621,4571,8192
1933,"KISII","55-59",16410,19062,35472
1934,"KISII",60,3598,4910,8508
1935,"KISII",61,3195,3618,6813
1936,"KISII",62,2234,2508,4742
1937,"KISII",63,2383,2658,5041
1938,"KISII",64,1701,1950,3651
1939,"KISII","60-64",13111,15644,28755
1940,"KISII",65,2519,3307,5826
1941,"KISII",66,1458,1525,2983
1942,"KISII",67,2289,2590,4879
1943,"KISII",68,984,1307,2291
1944,"KISII",69,1834,2418,4252
1945,"KISII","65-69",9084,11147,20231
1946,"KISII",70,1911,3214,5125
1947,"KISII",71,1594,1617,3211
1948,"KISII",72,1179,1099,2278
1949,"KISII",73,939,915,1854
1950,"KISII",74,975,1298,2273
1951,"KISII","70-74",6598,8143,14741
1952,"KISII",75,811,1130,1941
1953,"KISII",76,530,594,1124
1954,"KISII",77,824,853,1677
1955,"KISII",78,450,451,901
1956,"KISII",79,639,1208,1847
1957,"KISII","75-79",3254,4236,7490
1958,"KISII",80,709,1332,2041
1959,"KISII",81,467,680,1147
1960,"KISII",82,374,399,773
1961,"KISII",83,412,457,869
1962,"KISII",84,391,636,1027
1963,"KISII","80-84",2353,3504,5857
1964,"KISII",85,321,529,850
1965,"KISII",86,246,260,506
1966,"KISII",87,351,395,746
1967,"KISII",88,180,214,394
1968,"KISII",89,318,698,1016
1969,"KISII","85-89",1416,2096,3512
1970,"KISII",90,159,373,532
1971,"KISII",91,111,169,280
1972,"KISII",92,112,119,231
1973,"KISII",93,47,97,144
1974,"KISII",94,85,141,226
1975,"KISII","90-94",514,899,1413
1976,"KISII",95,89,143,232
1977,"KISII",96,41,61,102
1978,"KISII",97,57,81,138
1979,"KISII",98,27,61,88
1980,"KISII",99,49,112,161
1981,"KISII","95-99",263,458,721
1982,"KISII","100+",89,274,363
1983,"KISII","Not Stated",15,5,20
1985,"KISUMU","Total",344721,369939,714660
1986,"KISUMU",0,8082,7998,16080
1987,"KISUMU",1,8556,8281,16837
1988,"KISUMU",2,8647,8823,17470
1989,"KISUMU",3,8954,9010,17964
1990,"KISUMU",4,8888,9045,17933
1991,"KISUMU","0 - 4",43127,43157,86284
1992,"KISUMU",5,9616,9192,18808
1993,"KISUMU",6,9834,9727,19561
1994,"KISUMU",7,9575,9843,19418
1995,"KISUMU",8,9582,9421,19003
1996,"KISUMU",9,10685,10616,21301
1997,"KISUMU","5-9",49292,48799,98091
1998,"KISUMU",10,11782,11153,22935
1999,"KISUMU",11,10548,10753,21301
2000,"KISUMU",12,12321,11846,24167
2001,"KISUMU",13,11748,11611,23359
2002,"KISUMU",14,10697,10603,21300
2003,"KISUMU","10-14",57096,55966,113062
2004,"KISUMU",15,10544,10290,20834
2005,"KISUMU",16,9234,9238,18472
2006,"KISUMU",17,9583,8949,18532
2007,"KISUMU",18,7463,7046,14509
2008,"KISUMU",19,7794,7896,15690
2009,"KISUMU","15-19",44618,43419,88037
2010,"KISUMU",20,6695,7416,14111
2011,"KISUMU",21,5824,6562,12386
2012,"KISUMU",22,5082,6054,11136
2013,"KISUMU",23,5257,6349,11606
2014,"KISUMU",24,4744,5541,10285
2015,"KISUMU","20-24",27602,31922,59524
2016,"KISUMU",25,5316,6122,11438
2017,"KISUMU",26,4229,5144,9373
2018,"KISUMU",27,4625,5687,10312
2019,"KISUMU",28,3342,4006,7348
2020,"KISUMU",29,3462,4706,8168
2021,"KISUMU","25-29",20974,25665,46639
2022,"KISUMU",30,4895,6547,11442
2023,"KISUMU",31,3539,4491,8030
2024,"KISUMU",32,4499,5671,10170
2025,"KISUMU",33,3935,5115,9050
2026,"KISUMU",34,3836,4568,8404
2027,"KISUMU","30-34",20704,26392,47096
2028,"KISUMU",35,4669,4979,9648
2029,"KISUMU",36,3447,3123,6570
2030,"KISUMU",37,3751,3188,6939
2031,"KISUMU",38,2502,2148,4650
2032,"KISUMU",39,3127,2728,5855
2033,"KISUMU","35-39",17496,16166,33662
2034,"KISUMU",40,3800,3615,7415
2035,"KISUMU",41,3362,2993,6355
2036,"KISUMU",42,2975,2649,5624
2037,"KISUMU",43,2901,3222,6123
2038,"KISUMU",44,2268,2430,4698
2039,"KISUMU","40-44",15306,14909,30215
2040,"KISUMU",45,2924,3068,5992
2041,"KISUMU",46,2225,2164,4389
2042,"KISUMU",47,2336,2340,4676
2043,"KISUMU",48,1356,1452,2808
2044,"KISUMU",49,1516,1728,3244
2045,"KISUMU","45-49",10357,10752,21109
2046,"KISUMU",50,2061,2793,4854
2047,"KISUMU",51,1885,2582,4467
2048,"KISUMU",52,1399,1825,3224
2049,"KISUMU",53,1218,1550,2768
2050,"KISUMU",54,1363,1605,2968
2051,"KISUMU","50-54",7926,10355,18281
2052,"KISUMU",55,1538,1840,3378
2053,"KISUMU",56,1529,2241,3770
2054,"KISUMU",57,1729,2909,4638
2055,"KISUMU",58,1184,1556,2740
2056,"KISUMU",59,1460,2040,3500
2057,"KISUMU","55-59",7440,10586,18026
2058,"KISUMU",60,1864,2976,4840
2059,"KISUMU",61,1610,2106,3716
2060,"KISUMU",62,1235,1636,2871
2061,"KISUMU",63,1356,1790,3146
2062,"KISUMU",64,1053,1337,2390
2063,"KISUMU","60-64",7118,9845,16963
2064,"KISUMU",65,1512,2105,3617
2065,"KISUMU",66,1023,1473,2496
2066,"KISUMU",67,1577,2189,3766
2067,"KISUMU",68,597,781,1378
2068,"KISUMU",69,1119,1236,2355
2069,"KISUMU","65-69",5828,7784,13612
2070,"KISUMU",70,1473,2217,3690
2071,"KISUMU",71,1111,1162,2273
2072,"KISUMU",72,852,934,1786
2073,"KISUMU",73,689,763,1452
2074,"KISUMU",74,655,933,1588
2075,"KISUMU","70-74",4780,6009,10789
2076,"KISUMU",75,551,809,1360
2077,"KISUMU",76,476,739,1215
2078,"KISUMU",77,539,852,1391
2079,"KISUMU",78,276,383,659
2080,"KISUMU",79,366,739,1105
2081,"KISUMU","75-79",2208,3522,5730
2082,"KISUMU",80,473,897,1370
2083,"KISUMU",81,327,495,822
2084,"KISUMU",82,266,321,587
2085,"KISUMU",83,325,384,709
2086,"KISUMU",84,271,374,645
2087,"KISUMU","80-84",1662,2471,4133
2088,"KISUMU",85,200,355,555
2089,"KISUMU",86,163,192,355
2090,"KISUMU",87,212,355,567
2091,"KISUMU",88,78,151,229
2092,"KISUMU",89,121,347,468
2093,"KISUMU","85-89",774,1400,2174
2094,"KISUMU",90,75,204,279
2095,"KISUMU",91,64,123,187
2096,"KISUMU",92,57,72,129
2097,"KISUMU",93,41,61,102
2098,"KISUMU",94,29,47,76
2099,"KISUMU","90-94",266,507,773
2100,"KISUMU",95,34,63,97
2101,"KISUMU",96,17,43,60
2102,"KISUMU",97,17,32,49
2103,"KISUMU",98,15,32,47
2104,"KISUMU",99,20,52,72
2105,"KISUMU","95-99",103,222,325
2106,"KISUMU","100+",38,86,124
2107,"KISUMU","Not Stated",6,5,11
2109,"KITUI","Total",522943,559193,1082136
2110,"KITUI",0,10791,10681,21472
2111,"KITUI",1,11890,11664,23554
2112,"KITUI",2,12193,12083,24276
2113,"KITUI",3,12613,12500,25113
2114,"KITUI",4,12922,12545,25467
2115,"KITUI","0 - 4",60409,59473,119882
2116,"KITUI",5,13612,13277,26889
2117,"KITUI",6,13706,13419,27125
2118,"KITUI",7,13131,12781,25912
2119,"KITUI",8,14860,14627,29487
2120,"KITUI",9,15275,14831,30106
2121,"KITUI","5-9",70584,68935,139519
2122,"KITUI",10,16248,15732,31980
2123,"KITUI",11,16656,17256,33912
2124,"KITUI",12,18058,16753,34811
2125,"KITUI",13,17438,17019,34457
2126,"KITUI",14,17190,16644,33834
2127,"KITUI","10-14",85590,83404,168994
2128,"KITUI",15,17414,16702,34116
2129,"KITUI",16,16513,16174,32687
2130,"KITUI",17,16288,15233,31521
2131,"KITUI",18,12425,11376,23801
2132,"KITUI",19,12754,11457,24211
2133,"KITUI","15-19",75394,70942,146336
2134,"KITUI",20,10790,10258,21048
2135,"KITUI",21,8481,8451,16932
2136,"KITUI",22,7194,7505,14699
2137,"KITUI",23,7085,8041,15126
2138,"KITUI",24,6164,6960,13124
2139,"KITUI","20-24",39714,41215,80929
2140,"KITUI",25,7005,7629,14634
2141,"KITUI",26,5035,6114,11149
2142,"KITUI",27,5769,6351,12120
2143,"KITUI",28,4573,5553,10126
2144,"KITUI",29,5555,6878,12433
2145,"KITUI","25-29",27937,32525,60462
2146,"KITUI",30,6355,8292,14647
2147,"KITUI",31,5061,6166,11227
2148,"KITUI",32,5921,7639,13560
2149,"KITUI",33,5454,7235,12689
2150,"KITUI",34,4634,6166,10800
2151,"KITUI","30-34",27425,35498,62923
2152,"KITUI",35,6390,8011,14401
2153,"KITUI",36,4314,5350,9664
2154,"KITUI",37,5006,5579,10585
2155,"KITUI",38,3416,4185,7601
2156,"KITUI",39,5000,5704,10704
2157,"KITUI","35-39",24126,28829,52955
2158,"KITUI",40,4881,5448,10329
2159,"KITUI",41,5137,5457,10594
2160,"KITUI",42,4300,4955,9255
2161,"KITUI",43,4043,5160,9203
2162,"KITUI",44,3917,5137,9054
2163,"KITUI","40-44",22278,26157,48435
2164,"KITUI",45,5871,7097,12968
2165,"KITUI",46,4098,4776,8874
2166,"KITUI",47,4013,4779,8792
2167,"KITUI",48,2889,3409,6298
2168,"KITUI",49,3838,4666,8504
2169,"KITUI","45-49",20709,24727,45436
2170,"KITUI",50,3718,4757,8475
2171,"KITUI",51,3436,4209,7645
2172,"KITUI",52,2734,3100,5834
2173,"KITUI",53,2106,2392,4498
2174,"KITUI",54,2941,2989,5930
2175,"KITUI","50-54",14935,17447,32382
2176,"KITUI",55,3088,3040,6128
2177,"KITUI",56,3349,3519,6868
2178,"KITUI",57,2478,3005,5483
2179,"KITUI",58,1751,2417,4168
2180,"KITUI",59,2544,3551,6095
2181,"KITUI","55-59",13210,15532,28742
2182,"KITUI",60,3075,3795,6870
2183,"KITUI",61,2468,2927,5395
2184,"KITUI",62,1984,2167,4151
2185,"KITUI",63,2038,2392,4430
2186,"KITUI",64,1630,1929,3559
2187,"KITUI","60-64",11195,13210,24405
2188,"KITUI",65,2349,2842,5191
2189,"KITUI",66,1641,1671,3312
2190,"KITUI",67,2769,3073,5842
2191,"KITUI",68,1343,1578,2921
2192,"KITUI",69,1885,3090,4975
2193,"KITUI","65-69",9987,12254,22241
2194,"KITUI",70,2279,3711,5990
2195,"KITUI",71,1620,2091,3711
2196,"KITUI",72,1141,1398,2539
2197,"KITUI",73,1366,2489,3855
2198,"KITUI",74,1141,1922,3063
2199,"KITUI","70-74",7547,11611,19158
2200,"KITUI",75,1149,1456,2605
2201,"KITUI",76,739,925,1664
2202,"KITUI",77,916,1089,2005
2203,"KITUI",78,757,672,1429
2204,"KITUI",79,927,1740,2667
2205,"KITUI","75-79",4488,5882,10370
2206,"KITUI",80,1120,1919,3039
2207,"KITUI",81,598,865,1463
2208,"KITUI",82,529,470,999
2209,"KITUI",83,589,763,1352
2210,"KITUI",84,711,1254,1965
2211,"KITUI","80-84",3547,5271,8818
2212,"KITUI",85,454,619,1073
2213,"KITUI",86,338,247,585
2214,"KITUI",87,375,457,832
2215,"KITUI",88,195,208,403
2216,"KITUI",89,490,1044,1534
2217,"KITUI","85-89",1852,2575,4427
2218,"KITUI",90,433,923,1356
2219,"KITUI",91,278,694,972
2220,"KITUI",92,199,288,487
2221,"KITUI",93,130,222,352
2222,"KITUI",94,154,225,379
2223,"KITUI","90-94",1194,2352,3546
2224,"KITUI",95,166,303,469
2225,"KITUI",96,71,94,165
2226,"KITUI",97,108,81,189
2227,"KITUI",98,59,105,164
2228,"KITUI",99,146,289,435
2229,"KITUI","95-99",550,872,1422
2230,"KITUI","100+",268,476,744
2231,"KITUI","Not Stated",4,6,10
2233,"KWALE","Total",362726,377650,740376
2234,"KWALE",0,10626,10664,21290
2235,"KWALE",1,11099,10811,21910
2236,"KWALE",2,11621,11393,23014
2237,"KWALE",3,11717,11924,23641
2238,"KWALE",4,12551,12166,24717
2239,"KWALE","0 - 4",57614,56958,114572
2240,"KWALE",5,12964,12565,25529
2241,"KWALE",6,12303,11966,24269
2242,"KWALE",7,11651,11145,22796
2243,"KWALE",8,11080,11054,22134
2244,"KWALE",9,11625,11215,22840
2245,"KWALE","5-9",59623,57945,117568
2246,"KWALE",10,11787,11695,23482
2247,"KWALE",11,10653,10749,21402
2248,"KWALE",12,11892,11346,23238
2249,"KWALE",13,11807,11528,23335
2250,"KWALE",14,10470,10002,20472
2251,"KWALE","10-14",56609,55320,111929
2252,"KWALE",15,9835,9356,19191
2253,"KWALE",16,9116,8814,17930
2254,"KWALE",17,9005,8041,17046
2255,"KWALE",18,8165,7460,15625
2256,"KWALE",19,7707,7881,15588
2257,"KWALE","15-19",43828,41552,85380
2258,"KWALE",20,7111,7960,15071
2259,"KWALE",21,4954,5631,10585
2260,"KWALE",22,5124,6145,11269
2261,"KWALE",23,4927,6093,11020
2262,"KWALE",24,4426,5408,9834
2263,"KWALE","20-24",26542,31237,57779
2264,"KWALE",25,5498,6437,11935
2265,"KWALE",26,4328,5497,9825
2266,"KWALE",27,4356,5138,9494
2267,"KWALE",28,3756,4918,8674
2268,"KWALE",29,3652,4965,8617
2269,"KWALE","25-29",21590,26955,48545
2270,"KWALE",30,5233,7134,12367
2271,"KWALE",31,3244,4254,7498
2272,"KWALE",32,3984,5050,9034
2273,"KWALE",33,3296,4189,7485
2274,"KWALE",34,3280,3838,7118
2275,"KWALE","30-34",19037,24465,43502
2276,"KWALE",35,4537,5096,9633
2277,"KWALE",36,2988,3336,6324
2278,"KWALE",37,2811,3014,5825
2279,"KWALE",38,2210,2397,4607
2280,"KWALE",39,2447,2514,4961
2281,"KWALE","35-39",14993,16357,31350
2282,"KWALE",40,3725,4089,7814
2283,"KWALE",41,2915,3234,6149
2284,"KWALE",42,3114,3633,6747
2285,"KWALE",43,2586,3050,5636
2286,"KWALE",44,2252,2374,4626
2287,"KWALE","40-44",14592,16380,30972
2288,"KWALE",45,3626,3561,7187
2289,"KWALE",46,2167,2371,4538
2290,"KWALE",47,2414,2240,4654
2291,"KWALE",48,1771,1673,3444
2292,"KWALE",49,1960,1635,3595
2293,"KWALE","45-49",11938,11480,23418
2294,"KWALE",50,3097,3117,6214
2295,"KWALE",51,1926,1485,3411
2296,"KWALE",52,1495,1153,2648
2297,"KWALE",53,956,695,1651
2298,"KWALE",54,1199,852,2051
2299,"KWALE","50-54",8673,7302,15975
2300,"KWALE",55,1440,1166,2606
2301,"KWALE",56,1651,1504,3155
2302,"KWALE",57,1432,1431,2863
2303,"KWALE",58,1200,1147,2347
2304,"KWALE",59,1447,1833,3280
2305,"KWALE","55-59",7170,7081,14251
2306,"KWALE",60,2101,3121,5222
2307,"KWALE",61,1148,1566,2714
2308,"KWALE",62,1198,1251,2449
2309,"KWALE",63,1195,1445,2640
2310,"KWALE",64,995,1100,2095
2311,"KWALE","60-64",6637,8483,15120
2312,"KWALE",65,1616,1845,3461
2313,"KWALE",66,937,804,1741
2314,"KWALE",67,1297,1194,2491
2315,"KWALE",68,717,697,1414
2316,"KWALE",69,1037,1402,2439
2317,"KWALE","65-69",5604,5942,11546
2318,"KWALE",70,1525,2354,3879
2319,"KWALE",71,573,689,1262
2320,"KWALE",72,589,643,1232
2321,"KWALE",73,507,465,972
2322,"KWALE",74,555,614,1169
2323,"KWALE","70-74",3749,4765,8514
2324,"KWALE",75,683,682,1365
2325,"KWALE",76,346,330,676
2326,"KWALE",77,381,387,768
2327,"KWALE",78,305,250,555
2328,"KWALE",79,405,504,909
2329,"KWALE","75-79",2120,2153,4273
2330,"KWALE",80,523,918,1441
2331,"KWALE",81,197,216,413
2332,"KWALE",82,179,172,351
2333,"KWALE",83,170,209,379
2334,"KWALE",84,185,235,420
2335,"KWALE","80-84",1254,1750,3004
2336,"KWALE",85,189,274,463
2337,"KWALE",86,107,89,196
2338,"KWALE",87,120,136,256
2339,"KWALE",88,70,73,143
2340,"KWALE",89,173,256,429
2341,"KWALE","85-89",659,828,1487
2342,"KWALE",90,125,233,358
2343,"KWALE",91,49,55,104
2344,"KWALE",92,39,28,67
2345,"KWALE",93,22,28,50
2346,"KWALE",94,34,38,72
2347,"KWALE","90-94",269,382,651
2348,"KWALE",95,34,39,73
2349,"KWALE",96,21,23,44
2350,"KWALE",97,15,24,39
2351,"KWALE",98,15,22,37
2352,"KWALE",99,42,55,97
2353,"KWALE","95-99",127,163,290
2354,"KWALE","100+",93,146,239
2355,"KWALE","Not Stated",5,6,11
2357,"LAIKIPIA","Total",196277,194909,391186
2358,"LAIKIPIA",0,4929,4751,9680
2359,"LAIKIPIA",1,4655,4538,9193
2360,"LAIKIPIA",2,5066,4911,9977
2361,"LAIKIPIA",3,5468,5371,10839
2362,"LAIKIPIA",4,5344,5284,10628
2363,"LAIKIPIA","0 - 4",25462,24855,50317
2364,"LAIKIPIA",5,5239,5068,10307
2365,"LAIKIPIA",6,5383,5145,10528
2366,"LAIKIPIA",7,5201,5171,10372
2367,"LAIKIPIA",8,5184,5009,10193
2368,"LAIKIPIA",9,5010,4945,9955
2369,"LAIKIPIA","5-9",26017,25338,51355
2370,"LAIKIPIA",10,5918,5707,11625
2371,"LAIKIPIA",11,4784,4637,9421
2372,"LAIKIPIA",12,5799,5162,10961
2373,"LAIKIPIA",13,5504,5283,10787
2374,"LAIKIPIA",14,5341,4852,10193
2375,"LAIKIPIA","10-14",27346,25641,52987
2376,"LAIKIPIA",15,5436,4879,10315
2377,"LAIKIPIA",16,4870,4535,9405
2378,"LAIKIPIA",17,5235,4435,9670
2379,"LAIKIPIA",18,4254,3683,7937
2380,"LAIKIPIA",19,4008,3551,7559
2381,"LAIKIPIA","15-19",23803,21083,44886
2382,"LAIKIPIA",20,3653,3581,7234
2383,"LAIKIPIA",21,2975,2843,5818
2384,"LAIKIPIA",22,2825,3045,5870
2385,"LAIKIPIA",23,2724,2827,5551
2386,"LAIKIPIA",24,2452,2506,4958
2387,"LAIKIPIA","20-24",14629,14802,29431
2388,"LAIKIPIA",25,2854,2811,5665
2389,"LAIKIPIA",26,2110,2360,4470
2390,"LAIKIPIA",27,2244,2399,4643
2391,"LAIKIPIA",28,2074,2239,4313
2392,"LAIKIPIA",29,2122,2316,4438
2393,"LAIKIPIA","25-29",11404,12125,23529
2394,"LAIKIPIA",30,2917,3333,6250
2395,"LAIKIPIA",31,2068,2263,4331
2396,"LAIKIPIA",32,2487,2745,5232
2397,"LAIKIPIA",33,2077,2335,4412
2398,"LAIKIPIA",34,1948,2107,4055
2399,"LAIKIPIA","30-34",11497,12783,24280
2400,"LAIKIPIA",35,3094,3113,6207
2401,"LAIKIPIA",36,1989,1863,3852
2402,"LAIKIPIA",37,2034,1774,3808
2403,"LAIKIPIA",38,1720,1574,3294
2404,"LAIKIPIA",39,1904,1795,3699
2405,"LAIKIPIA","35-39",10741,10119,20860
2406,"LAIKIPIA",40,2674,2367,5041
2407,"LAIKIPIA",41,2025,2026,4051
2408,"LAIKIPIA",42,2024,1984,4008
2409,"LAIKIPIA",43,1737,1685,3422
2410,"LAIKIPIA",44,1413,1452,2865
2411,"LAIKIPIA","40-44",9873,9514,19387
2412,"LAIKIPIA",45,2312,2208,4520
2413,"LAIKIPIA",46,1680,1715,3395
2414,"LAIKIPIA",47,1638,1664,3302
2415,"LAIKIPIA",48,1244,1279,2523
2416,"LAIKIPIA",49,1444,1463,2907
2417,"LAIKIPIA","45-49",8318,8329,16647
2418,"LAIKIPIA",50,1897,1995,3892
2419,"LAIKIPIA",51,1415,1387,2802
2420,"LAIKIPIA",52,1391,1397,2788
2421,"LAIKIPIA",53,967,1039,2006
2422,"LAIKIPIA",54,1247,1287,2534
2423,"LAIKIPIA","50-54",6917,7105,14022
2424,"LAIKIPIA",55,1426,1385,2811
2425,"LAIKIPIA",56,1361,1339,2700
2426,"LAIKIPIA",57,1060,1241,2301
2427,"LAIKIPIA",58,917,1093,2010
2428,"LAIKIPIA",59,1092,1226,2318
2429,"LAIKIPIA","55-59",5856,6284,12140
2430,"LAIKIPIA",60,1347,1558,2905
2431,"LAIKIPIA",61,880,988,1868
2432,"LAIKIPIA",62,826,826,1652
2433,"LAIKIPIA",63,674,760,1434
2434,"LAIKIPIA",64,481,546,1027
2435,"LAIKIPIA","60-64",4208,4678,8886
2436,"LAIKIPIA",65,849,942,1791
2437,"LAIKIPIA",66,558,628,1186
2438,"LAIKIPIA",67,946,1119,2065
2439,"LAIKIPIA",68,444,502,946
2440,"LAIKIPIA",69,700,779,1479
2441,"LAIKIPIA","65-69",3497,3970,7467
2442,"LAIKIPIA",70,985,1200,2185
2443,"LAIKIPIA",71,592,728,1320
2444,"LAIKIPIA",72,618,533,1151
2445,"LAIKIPIA",73,481,440,921
2446,"LAIKIPIA",74,407,472,879
2447,"LAIKIPIA","70-74",3083,3373,6456
2448,"LAIKIPIA",75,398,528,926
2449,"LAIKIPIA",76,426,700,1126
2450,"LAIKIPIA",77,309,366,675
2451,"LAIKIPIA",78,251,228,479
2452,"LAIKIPIA",79,276,359,635
2453,"LAIKIPIA","75-79",1660,2181,3841
2454,"LAIKIPIA",80,385,496,881
2455,"LAIKIPIA",81,186,242,428
2456,"LAIKIPIA",82,153,160,313
2457,"LAIKIPIA",83,172,174,346
2458,"LAIKIPIA",84,164,190,354
2459,"LAIKIPIA","80-84",1060,1262,2322
2460,"LAIKIPIA",85,139,164,303
2461,"LAIKIPIA",86,99,172,271
2462,"LAIKIPIA",87,112,120,232
2463,"LAIKIPIA",88,51,66,117
2464,"LAIKIPIA",89,124,204,328
2465,"LAIKIPIA","85-89",525,726,1251
2466,"LAIKIPIA",90,69,149,218
2467,"LAIKIPIA",91,76,105,181
2468,"LAIKIPIA",92,35,44,79
2469,"LAIKIPIA",93,23,40,63
2470,"LAIKIPIA",94,22,49,71
2471,"LAIKIPIA","90-94",225,387,612
2472,"LAIKIPIA",95,32,66,98
2473,"LAIKIPIA",96,13,33,46
2474,"LAIKIPIA",97,19,40,59
2475,"LAIKIPIA",98,15,22,37
2476,"LAIKIPIA",99,21,53,74
2477,"LAIKIPIA","95-99",100,214,314
2478,"LAIKIPIA","100+",54,138,192
2479,"LAIKIPIA","Not Stated",2,2,4
2481,"LAMU","Total",56570,48902,105472
2482,"LAMU",0,1344,1282,2626
2483,"LAMU",1,1318,1264,2582
2484,"LAMU",2,1469,1363,2832
2485,"LAMU",3,1476,1423,2899
2486,"LAMU",4,1591,1456,3047
2487,"LAMU","0 - 4",7198,6788,13986
2488,"LAMU",5,1552,1435,2987
2489,"LAMU",6,1497,1414,2911
2490,"LAMU",7,1377,1402,2779
2491,"LAMU",8,1452,1446,2898
2492,"LAMU",9,1409,1341,2750
2493,"LAMU","5-9",7287,7038,14325
2494,"LAMU",10,1538,1444,2982
2495,"LAMU",11,1297,1262,2559
2496,"LAMU",12,1514,1356,2870
2497,"LAMU",13,1530,1457,2987
2498,"LAMU",14,1395,1233,2628
2499,"LAMU","10-14",7274,6752,14026
2500,"LAMU",15,1323,1208,2531
2501,"LAMU",16,1244,1114,2358
2502,"LAMU",17,1302,1052,2354
2503,"LAMU",18,1091,975,2066
2504,"LAMU",19,1081,928,2009
2505,"LAMU","15-19",6041,5277,11318
2506,"LAMU",20,1127,984,2111
2507,"LAMU",21,934,739,1673
2508,"LAMU",22,1122,825,1947
2509,"LAMU",23,1052,791,1843
2510,"LAMU",24,1056,637,1693
2511,"LAMU","20-24",5291,3976,9267
2512,"LAMU",25,1126,771,1897
2513,"LAMU",26,980,765,1745
2514,"LAMU",27,940,659,1599
2515,"LAMU",28,771,552,1323
2516,"LAMU",29,765,520,1285
2517,"LAMU","25-29",4582,3267,7849
2518,"LAMU",30,991,805,1796
2519,"LAMU",31,827,671,1498
2520,"LAMU",32,877,732,1609
2521,"LAMU",33,695,580,1275
2522,"LAMU",34,627,531,1158
2523,"LAMU","30-34",4017,3319,7336
2524,"LAMU",35,840,712,1552
2525,"LAMU",36,687,568,1255
2526,"LAMU",37,614,491,1105
2527,"LAMU",38,444,351,795
2528,"LAMU",39,522,359,881
2529,"LAMU","35-39",3107,2481,5588
2530,"LAMU",40,715,538,1253
2531,"LAMU",41,769,689,1458
2532,"LAMU",42,536,460,996
2533,"LAMU",43,425,343,768
2534,"LAMU",44,341,280,621
2535,"LAMU","40-44",2786,2310,5096
2536,"LAMU",45,737,654,1391
2537,"LAMU",46,471,370,841
2538,"LAMU",47,426,281,707
2539,"LAMU",48,343,247,590
2540,"LAMU",49,389,304,693
2541,"LAMU","45-49",2366,1856,4222
2542,"LAMU",50,546,415,961
2543,"LAMU",51,389,306,695
2544,"LAMU",52,314,263,577
2545,"LAMU",53,206,177,383
2546,"LAMU",54,242,186,428
2547,"LAMU","50-54",1697,1347,3044
2548,"LAMU",55,320,218,538
2549,"LAMU",56,337,301,638
2550,"LAMU",57,258,278,536
2551,"LAMU",58,261,235,496
2552,"LAMU",59,291,263,554
2553,"LAMU","55-59",1467,1295,2762
2554,"LAMU",60,337,356,693
2555,"LAMU",61,205,240,445
2556,"LAMU",62,217,161,378
2557,"LAMU",63,214,161,375
2558,"LAMU",64,169,129,298
2559,"LAMU","60-64",1142,1047,2189
2560,"LAMU",65,238,246,484
2561,"LAMU",66,147,153,300
2562,"LAMU",67,215,159,374
2563,"LAMU",68,130,112,242
2564,"LAMU",69,177,129,306
2565,"LAMU","65-69",907,799,1706
2566,"LAMU",70,227,266,493
2567,"LAMU",71,136,170,306
2568,"LAMU",72,142,83,225
2569,"LAMU",73,111,59,170
2570,"LAMU",74,90,67,157
2571,"LAMU","70-74",706,645,1351
2572,"LAMU",75,94,104,198
2573,"LAMU",76,82,73,155
2574,"LAMU",77,65,34,99
2575,"LAMU",78,51,30,81
2576,"LAMU",79,53,50,103
2577,"LAMU","75-79",345,291,636
2578,"LAMU",80,77,110,187
2579,"LAMU",81,40,38,78
2580,"LAMU",82,20,17,37
2581,"LAMU",83,32,18,50
2582,"LAMU",84,32,23,55
2583,"LAMU","80-84",201,206,407
2584,"LAMU",85,23,26,49
2585,"LAMU",86,16,22,38
2586,"LAMU",87,23,13,36
2587,"LAMU",88,12,9,21
2588,"LAMU",89,14,19,33
2589,"LAMU","85-89",88,89,177
2590,"LAMU",90,16,30,46
2591,"LAMU",91,5,15,20
2592,"LAMU",92,10,5,15
2593,"LAMU",93,2,6,8
2594,"LAMU",94,5,4,9
2595,"LAMU","90-94",38,60,98
2596,"LAMU",95,5,5,10
2597,"LAMU",96,3,6,9
2598,"LAMU",97,4,5,9
2599,"LAMU",98,2,2,4
2600,"LAMU",99,2,11,13
2601,"LAMU","95-99",16,29,45
2602,"LAMU","100+",11,29,40
2603,"LAMU","Not Stated",3,1,4
2605,"MACHAKOS","Total",504247,503582,1007829
2606,"MACHAKOS",0,9076,9016,18092
2607,"MACHAKOS",1,9786,9555,19341
2608,"MACHAKOS",2,9717,9647,19364
2609,"MACHAKOS",3,10296,10315,20611
2610,"MACHAKOS",4,10789,10172,20961
2611,"MACHAKOS","0 - 4",49664,48705,98369
2612,"MACHAKOS",5,10904,10319,21223
2613,"MACHAKOS",6,10667,10412,21079
2614,"MACHAKOS",7,11158,10622,21780
2615,"MACHAKOS",8,11370,11225,22595
2616,"MACHAKOS",9,12618,11727,24345
2617,"MACHAKOS","5-9",56717,54305,111022
2618,"MACHAKOS",10,12783,12291,25074
2619,"MACHAKOS",11,12690,12934,25624
2620,"MACHAKOS",12,13964,13293,27257
2621,"MACHAKOS",13,13655,13166,26821
2622,"MACHAKOS",14,13646,12508,26154
2623,"MACHAKOS","10-14",66738,64192,130930
2624,"MACHAKOS",15,13258,12712,25970
2625,"MACHAKOS",16,12745,12002,24747
2626,"MACHAKOS",17,13319,11895,25214
2627,"MACHAKOS",18,10423,8956,19379
2628,"MACHAKOS",19,10953,8849,19802
2629,"MACHAKOS","15-19",60698,54414,115112
2630,"MACHAKOS",20,10000,8438,18438
2631,"MACHAKOS",21,8825,7446,16271
2632,"MACHAKOS",22,7755,6821,14576
2633,"MACHAKOS",23,8320,7597,15917
2634,"MACHAKOS",24,7319,6563,13882
2635,"MACHAKOS","20-24",42219,36865,79084
2636,"MACHAKOS",25,7316,6638,13954
2637,"MACHAKOS",26,5993,5925,11918
2638,"MACHAKOS",27,6425,6166,12591
2639,"MACHAKOS",28,5556,5770,11326
2640,"MACHAKOS",29,6795,6818,13613
2641,"MACHAKOS","25-29",32085,31317,63402
2642,"MACHAKOS",30,7541,8094,15635
2643,"MACHAKOS",31,6130,6139,12269
2644,"MACHAKOS",32,7267,7687,14954
2645,"MACHAKOS",33,6539,7175,13714
2646,"MACHAKOS",34,5932,6147,12079
2647,"MACHAKOS","30-34",33409,35242,68651
2648,"MACHAKOS",35,7557,7759,15316
2649,"MACHAKOS",36,5873,5983,11856
2650,"MACHAKOS",37,6548,6108,12656
2651,"MACHAKOS",38,4830,4626,9456
2652,"MACHAKOS",39,6371,6272,12643
2653,"MACHAKOS","35-39",31179,30748,61927
2654,"MACHAKOS",40,6405,6271,12676
2655,"MACHAKOS",41,6621,6405,13026
2656,"MACHAKOS",42,5536,5545,11081
2657,"MACHAKOS",43,5117,5840,10957
2658,"MACHAKOS",44,4441,4445,8886
2659,"MACHAKOS","40-44",28120,28506,56626
2660,"MACHAKOS",45,6059,5875,11934
2661,"MACHAKOS",46,4811,4490,9301
2662,"MACHAKOS",47,4887,4559,9446
2663,"MACHAKOS",48,3423,3544,6967
2664,"MACHAKOS",49,4669,4769,9438
2665,"MACHAKOS","45-49",23849,23237,47086
2666,"MACHAKOS",50,4532,5116,9648
2667,"MACHAKOS",51,3922,4299,8221
2668,"MACHAKOS",52,3155,3275,6430
2669,"MACHAKOS",53,2640,2804,5444
2670,"MACHAKOS",54,3150,3306,6456
2671,"MACHAKOS","50-54",17399,18800,36199
2672,"MACHAKOS",55,3494,3490,6984
2673,"MACHAKOS",56,4010,4251,8261
2674,"MACHAKOS",57,3084,3942,7026
2675,"MACHAKOS",58,2368,2768,5136
2676,"MACHAKOS",59,3525,3859,7384
2677,"MACHAKOS","55-59",16481,18310,34791
2678,"MACHAKOS",60,4083,4447,8530
2679,"MACHAKOS",61,3594,3731,7325
2680,"MACHAKOS",62,2806,2830,5636
2681,"MACHAKOS",63,2962,3163,6125
2682,"MACHAKOS",64,1973,2144,4117
2683,"MACHAKOS","60-64",15418,16315,31733
2684,"MACHAKOS",65,2792,3164,5956
2685,"MACHAKOS",66,1838,2161,3999
2686,"MACHAKOS",67,3396,4208,7604
2687,"MACHAKOS",68,1318,1602,2920
2688,"MACHAKOS",69,2002,2712,4714
2689,"MACHAKOS","65-69",11346,13847,25193
2690,"MACHAKOS",70,2396,3165,5561
2691,"MACHAKOS",71,1846,2470,4316
2692,"MACHAKOS",72,1378,1428,2806
2693,"MACHAKOS",73,1263,1471,2734
2694,"MACHAKOS",74,1185,1634,2819
2695,"MACHAKOS","70-74",8068,10168,18236
2696,"MACHAKOS",75,917,1290,2207
2697,"MACHAKOS",76,708,1210,1918
2698,"MACHAKOS",77,929,1570,2499
2699,"MACHAKOS",78,623,729,1352
2700,"MACHAKOS",79,665,1639,2304
2701,"MACHAKOS","75-79",3842,6438,10280
2702,"MACHAKOS",80,1004,1726,2730
2703,"MACHAKOS",81,669,990,1659
2704,"MACHAKOS",82,578,600,1178
2705,"MACHAKOS",83,619,850,1469
2706,"MACHAKOS",84,507,864,1371
2707,"MACHAKOS","80-84",3377,5030,8407
2708,"MACHAKOS",85,407,649,1056
2709,"MACHAKOS",86,294,309,603
2710,"MACHAKOS",87,403,668,1071
2711,"MACHAKOS",88,198,239,437
2712,"MACHAKOS",89,383,1177,1560
2713,"MACHAKOS","85-89",1685,3042,4727
2714,"MACHAKOS",90,300,711,1011
2715,"MACHAKOS",91,408,856,1264
2716,"MACHAKOS",92,171,292,463
2717,"MACHAKOS",93,129,250,379
2718,"MACHAKOS",94,117,269,386
2719,"MACHAKOS","90-94",1125,2378,3503
2720,"MACHAKOS",95,174,358,532
2721,"MACHAKOS",96,92,143,235
2722,"MACHAKOS",97,112,132,244
2723,"MACHAKOS",98,70,129,199
2724,"MACHAKOS",99,105,360,465
2725,"MACHAKOS","95-99",553,1122,1675
2726,"MACHAKOS","100+",267,600,867
2727,"MACHAKOS","Not Stated",8,1,9
2729,"MAKUENI","Total",450482,460075,910557
2730,"MAKUENI",0,7902,7982,15884
2731,"MAKUENI",1,8888,8671,17559
2732,"MAKUENI",2,8733,8725,17458
2733,"MAKUENI",3,9341,8923,18264
2734,"MAKUENI",4,9603,9317,18920
2735,"MAKUENI","0 - 4",44467,43618,88085
2736,"MAKUENI",5,10029,9649,19678
2737,"MAKUENI",6,9841,9636,19477
2738,"MAKUENI",7,10399,10099,20498
2739,"MAKUENI",8,11009,10713,21722
2740,"MAKUENI",9,11822,11525,23347
2741,"MAKUENI","5-9",53100,51622,104722
2742,"MAKUENI",10,12410,12171,24581
2743,"MAKUENI",11,12605,12766,25371
2744,"MAKUENI",12,13892,13201,27093
2745,"MAKUENI",13,13337,13311,26648
2746,"MAKUENI",14,13350,12631,25981
2747,"MAKUENI","10-14",65594,64080,129674
2748,"MAKUENI",15,13513,12886,26399
2749,"MAKUENI",16,12812,12371,25183
2750,"MAKUENI",17,13452,12215,25667
2751,"MAKUENI",18,10423,9088,19511
2752,"MAKUENI",19,10789,8999,19788
2753,"MAKUENI","15-19",60989,55559,116548
2754,"MAKUENI",20,9313,7880,17193
2755,"MAKUENI",21,7773,6864,14637
2756,"MAKUENI",22,6713,5975,12688
2757,"MAKUENI",23,6867,6588,13455
2758,"MAKUENI",24,6279,5804,12083
2759,"MAKUENI","20-24",36945,33111,70056
2760,"MAKUENI",25,6618,6210,12828
2761,"MAKUENI",26,5357,5622,10979
2762,"MAKUENI",27,5725,5545,11270
2763,"MAKUENI",28,4575,4770,9345
2764,"MAKUENI",29,5672,5869,11541
2765,"MAKUENI","25-29",27947,28016,55963
2766,"MAKUENI",30,6365,7080,13445
2767,"MAKUENI",31,4985,5329,10314
2768,"MAKUENI",32,5773,6462,12235
2769,"MAKUENI",33,5473,6190,11663
2770,"MAKUENI",34,4606,5276,9882
2771,"MAKUENI","30-34",27202,30337,57539
2772,"MAKUENI",35,6481,6804,13285
2773,"MAKUENI",36,4592,4809,9401
2774,"MAKUENI",37,5206,5045,10251
2775,"MAKUENI",38,3533,3780,7313
2776,"MAKUENI",39,4911,5140,10051
2777,"MAKUENI","35-39",24723,25578,50301
2778,"MAKUENI",40,5016,5140,10156
2779,"MAKUENI",41,5127,5026,10153
2780,"MAKUENI",42,4333,4265,8598
2781,"MAKUENI",43,3923,4506,8429
2782,"MAKUENI",44,3756,4266,8022
2783,"MAKUENI","40-44",22155,23203,45358
2784,"MAKUENI",45,5488,6180,11668
2785,"MAKUENI",46,4045,4488,8533
2786,"MAKUENI",47,4094,4533,8627
2787,"MAKUENI",48,2881,3102,5983
2788,"MAKUENI",49,4031,4599,8630
2789,"MAKUENI","45-49",20539,22902,43441
2790,"MAKUENI",50,3804,4150,7954
2791,"MAKUENI",51,3356,3489,6845
2792,"MAKUENI",52,2577,2773,5350
2793,"MAKUENI",53,2258,2351,4609
2794,"MAKUENI",54,2842,2788,5630
2795,"MAKUENI","50-54",14837,15551,30388
2796,"MAKUENI",55,2797,2832,5629
2797,"MAKUENI",56,2758,3226,5984
2798,"MAKUENI",57,2606,3365,5971
2799,"MAKUENI",58,1907,2169,4076
2800,"MAKUENI",59,2807,3229,6036
2801,"MAKUENI","55-59",12875,14821,27696
2802,"MAKUENI",60,3176,3708,6884
2803,"MAKUENI",61,2740,3116,5856
2804,"MAKUENI",62,2167,2410,4577
2805,"MAKUENI",63,2334,2684,5018
2806,"MAKUENI",64,1668,1858,3526
2807,"MAKUENI","60-64",12085,13776,25861
2808,"MAKUENI",65,2438,3103,5541
2809,"MAKUENI",66,1563,1719,3282
2810,"MAKUENI",67,2879,3645,6524
2811,"MAKUENI",68,1171,1513,2684
2812,"MAKUENI",69,1826,2431,4257
2813,"MAKUENI","65-69",9877,12411,22288
2814,"MAKUENI",70,2145,2979,5124
2815,"MAKUENI",71,1646,2084,3730
2816,"MAKUENI",72,1230,1195,2425
2817,"MAKUENI",73,1156,1436,2592
2818,"MAKUENI",74,1076,1621,2697
2819,"MAKUENI","70-74",7253,9315,16568
2820,"MAKUENI",75,835,1241,2076
2821,"MAKUENI",76,614,836,1450
2822,"MAKUENI",77,904,1331,2235
2823,"MAKUENI",78,560,648,1208
2824,"MAKUENI",79,671,1496,2167
2825,"MAKUENI","75-79",3584,5552,9136
2826,"MAKUENI",80,907,1600,2507
2827,"MAKUENI",81,530,771,1301
2828,"MAKUENI",82,449,500,949
2829,"MAKUENI",83,569,687,1256
2830,"MAKUENI",84,445,785,1230
2831,"MAKUENI","80-84",2900,4343,7243
2832,"MAKUENI",85,353,509,862
2833,"MAKUENI",86,244,268,512
2834,"MAKUENI",87,341,533,874
2835,"MAKUENI",88,172,206,378
2836,"MAKUENI",89,403,1053,1456
2837,"MAKUENI","85-89",1513,2569,4082
2838,"MAKUENI",90,305,758,1063
2839,"MAKUENI",91,280,741,1021
2840,"MAKUENI",92,201,317,518
2841,"MAKUENI",93,113,291,404
2842,"MAKUENI",94,108,234,342
2843,"MAKUENI","90-94",1007,2341,3348
2844,"MAKUENI",95,189,279,468
2845,"MAKUENI",96,66,93,159
2846,"MAKUENI",97,111,103,214
2847,"MAKUENI",98,75,94,169
2848,"MAKUENI",99,144,267,411
2849,"MAKUENI","95-99",585,836,1421
2850,"MAKUENI","100+",301,530,831
2851,"MAKUENI","Not Stated",4,4,8
2853,"MANDERA","Total",299428,297535,596963
2854,"MANDERA",0,5806,7430,13236
2855,"MANDERA",1,7999,9630,17629
2856,"MANDERA",2,14479,17189,31668
2857,"MANDERA",3,9782,11812,21594
2858,"MANDERA",4,14751,16873,31624
2859,"MANDERA","0 - 4",52817,62934,115751
2860,"MANDERA",5,9717,11189,20906
2861,"MANDERA",6,14651,16664,31315
2862,"MANDERA",7,8394,9432,17826
2863,"MANDERA",8,14908,15784,30692
2864,"MANDERA",9,7864,8937,16801
2865,"MANDERA","5-9",55534,62006,117540
2866,"MANDERA",10,16057,16007,32064
2867,"MANDERA",11,6494,7976,14470
2868,"MANDERA",12,13783,10588,24371
2869,"MANDERA",13,7859,6294,14153
2870,"MANDERA",14,10996,8224,19220
2871,"MANDERA","10-14",55189,49089,104278
2872,"MANDERA",15,10159,7367,17526
2873,"MANDERA",16,9842,7609,17451
2874,"MANDERA",17,7676,6334,14010
2875,"MANDERA",18,8913,7648,16561
2876,"MANDERA",19,3808,3692,7500
2877,"MANDERA","15-19",40398,32650,73048
2878,"MANDERA",20,9581,8818,18399
2879,"MANDERA",21,3220,3216,6436
2880,"MANDERA",22,4573,5177,9750
2881,"MANDERA",23,3248,3275,6523
2882,"MANDERA",24,3270,3539,6809
2883,"MANDERA","20-24",23892,24025,47917
2884,"MANDERA",25,5533,5702,11235
2885,"MANDERA",26,3072,3358,6430
2886,"MANDERA",27,2625,3060,5685
2887,"MANDERA",28,3469,4175,7644
2888,"MANDERA",29,2189,2526,4715
2889,"MANDERA","25-29",16888,18821,35709
2890,"MANDERA",30,6719,6854,13573
2891,"MANDERA",31,1781,2192,3973
2892,"MANDERA",32,2832,3092,5924
2893,"MANDERA",33,1649,1919,3568
2894,"MANDERA",34,1558,1528,3086
2895,"MANDERA","30-34",14539,15585,30124
2896,"MANDERA",35,3279,3430,6709
2897,"MANDERA",36,1418,1796,3214
2898,"MANDERA",37,1184,1324,2508
2899,"MANDERA",38,1874,2230,4104
2900,"MANDERA",39,1347,1563,2910
2901,"MANDERA","35-39",9102,10343,19445
2902,"MANDERA",40,5083,4200,9283
2903,"MANDERA",41,1466,1487,2953
2904,"MANDERA",42,1610,1332,2942
2905,"MANDERA",43,1046,873,1919
2906,"MANDERA",44,710,512,1222
2907,"MANDERA","40-44",9915,8404,18319
2908,"MANDERA",45,2342,1702,4044
2909,"MANDERA",46,766,615,1381
2910,"MANDERA",47,745,571,1316
2911,"MANDERA",48,934,726,1660
2912,"MANDERA",49,716,530,1246
2913,"MANDERA","45-49",5503,4144,9647
2914,"MANDERA",51,500,386,886
2915,"MANDERA",52,855,531,1386
2916,"MANDERA",53,486,360,846
2917,"MANDERA",54,612,381,993
2918,"MANDERA","50-54",5033,3217,8250
2919,"MANDERA",55,841,456,1297
2920,"MANDERA",56,570,335,905
2921,"MANDERA",57,347,282,629
2922,"MANDERA",58,479,313,792
2923,"MANDERA",59,449,354,803
2924,"MANDERA","55-59",2686,1740,4426
2925,"MANDERA",60,1674,959,2633
2926,"MANDERA",61,363,331,694
2927,"MANDERA",62,470,201,671
2928,"MANDERA",63,327,205,532
2929,"MANDERA",64,292,149,441
2930,"MANDERA","60-64",3126,1845,4971
2931,"MANDERA",65,530,290,820
2932,"MANDERA",66,196,149,345
2933,"MANDERA",67,248,127,375
2934,"MANDERA",68,197,114,311
2935,"MANDERA",69,304,120,424
2936,"MANDERA","65-69",1475,800,2275
2937,"MANDERA",70,855,555,1410
2938,"MANDERA",71,184,167,351
2939,"MANDERA",72,242,99,341
2940,"MANDERA",73,102,54,156
2941,"MANDERA",74,132,47,179
2942,"MANDERA","70-74",1515,922,2437
2943,"MANDERA",75,209,100,309
2944,"MANDERA",76,108,47,155
2945,"MANDERA",77,88,40,128
2946,"MANDERA",78,113,59,172
2947,"MANDERA",79,121,57,178
2948,"MANDERA","75-79",639,303,942
2949,"MANDERA",80,407,278,685
2950,"MANDERA",81,103,97,200
2951,"MANDERA",82,103,37,140
2952,"MANDERA",83,50,18,68
2953,"MANDERA",84,52,22,74
2954,"MANDERA","80-84",715,452,1167
2955,"MANDERA",85,85,34,119
2956,"MANDERA",86,36,20,56
2957,"MANDERA",87,40,17,57
2958,"MANDERA",88,38,13,51
2959,"MANDERA",89,37,22,59
2960,"MANDERA","85-89",236,106,342
2961,"MANDERA",90,97,79,176
2962,"MANDERA",91,25,25,50
2963,"MANDERA",92,28,9,37
2964,"MANDERA",93,7,3,10
2965,"MANDERA",94,12,6,18
2966,"MANDERA","90-94",169,122,291
2967,"MANDERA",95,18,7,25
2968,"MANDERA",96,7,5,12
2969,"MANDERA",97,2,2,4
2970,"MANDERA",98,3,3,6
2971,"MANDERA",99,9,1,10
2972,"MANDERA","95-99",39,18,57
2973,"MANDERA","100+",16,9,25
2974,"MANDERA","Not Stated",2,"-",2
2975,"MANDERA",,,,
2977,"MARSABIT","Total",188758,163772,352530
2978,"MARSABIT",0,3981,3911,7892
2979,"MARSABIT",1,4620,4428,9048
2980,"MARSABIT",2,6037,5733,11770
2981,"MARSABIT",3,6155,5825,11980
2982,"MARSABIT",4,6719,6209,12928
2983,"MARSABIT","0 - 4",27512,26106,53618
2984,"MARSABIT",5,6418,6070,12488
2985,"MARSABIT",6,6936,6558,13494
2986,"MARSABIT",7,5506,5130,10636
2987,"MARSABIT",8,7114,6902,14016
2988,"MARSABIT",9,4729,4517,9246
2989,"MARSABIT","5-9",30703,29177,59880
2990,"MARSABIT",10,8896,8104,17000
2991,"MARSABIT",11,3696,4018,7714
2992,"MARSABIT",12,7416,5529,12945
2993,"MARSABIT",13,4977,4075,9052
2994,"MARSABIT",14,5427,4256,9683
2995,"MARSABIT","10-14",30412,25982,56394
2996,"MARSABIT",15,7018,4972,11990
2997,"MARSABIT",16,4968,3667,8635
2998,"MARSABIT",17,4921,3194,8115
2999,"MARSABIT",18,5034,3837,8871
3000,"MARSABIT",19,2840,2150,4990
3001,"MARSABIT","15-19",24781,17820,42601
3002,"MARSABIT",20,6183,4756,10939
3003,"MARSABIT",21,2535,2166,4701
3004,"MARSABIT",22,2995,2875,5870
3005,"MARSABIT",23,2801,2521,5322
3006,"MARSABIT",24,2666,2291,4957
3007,"MARSABIT","20-24",17180,14609,31789
3008,"MARSABIT",25,4527,3934,8461
3009,"MARSABIT",26,2324,2003,4327
3010,"MARSABIT",27,2181,1854,4035
3011,"MARSABIT",28,2670,2241,4911
3012,"MARSABIT",29,2039,1795,3834
3013,"MARSABIT","25-29",13741,11827,25568
3014,"MARSABIT",30,5121,3954,9075
3015,"MARSABIT",31,1376,1660,3036
3016,"MARSABIT",32,1885,1745,3630
3017,"MARSABIT",33,1430,1490,2920
3018,"MARSABIT",34,1274,1235,2509
3019,"MARSABIT","30-34",11086,10084,21170
3020,"MARSABIT",35,2619,2274,4893
3021,"MARSABIT",36,1262,1179,2441
3022,"MARSABIT",37,1141,992,2133
3023,"MARSABIT",38,1126,915,2041
3024,"MARSABIT",39,876,679,1555
3025,"MARSABIT","35-39",7024,6039,13063
3026,"MARSABIT",40,3121,2096,5217
3027,"MARSABIT",41,1201,1208,2409
3028,"MARSABIT",42,1082,781,1863
3029,"MARSABIT",43,817,654,1471
3030,"MARSABIT",44,422,369,791
3031,"MARSABIT","40-44",6643,5108,11751
3032,"MARSABIT",45,1877,1565,3442
3033,"MARSABIT",46,715,775,1490
3034,"MARSABIT",47,665,591,1256
3035,"MARSABIT",48,628,511,1139
3036,"MARSABIT",49,522,494,1016
3037,"MARSABIT","45-49",4407,3936,8343
3038,"MARSABIT",50,2018,1600,3618
3039,"MARSABIT",51,467,509,976
3040,"MARSABIT",52,710,573,1283
3041,"MARSABIT",53,417,357,774
3042,"MARSABIT",54,523,431,954
3043,"MARSABIT","50-54",4135,3470,7605
3044,"MARSABIT",55,753,599,1352
3045,"MARSABIT",56,554,420,974
3046,"MARSABIT",57,425,365,790
3047,"MARSABIT",58,477,428,905
3048,"MARSABIT",59,438,494,932
3049,"MARSABIT","55-59",2647,2306,4953
3050,"MARSABIT",60,1530,1142,2672
3051,"MARSABIT",61,358,386,744
3052,"MARSABIT",62,346,312,658
3053,"MARSABIT",63,299,271,570
3054,"MARSABIT",64,243,214,457
3055,"MARSABIT","60-64",2776,2325,5101
3056,"MARSABIT",65,551,440,991
3057,"MARSABIT",66,223,233,456
3058,"MARSABIT",67,264,206,470
3059,"MARSABIT",68,248,170,418
3060,"MARSABIT",69,275,362,637
3061,"MARSABIT","65-69",1561,1411,2972
3062,"MARSABIT",70,1117,900,2017
3063,"MARSABIT",71,254,297,551
3064,"MARSABIT",72,269,200,469
3065,"MARSABIT",73,171,137,308
3066,"MARSABIT",74,176,146,322
3067,"MARSABIT","70-74",1987,1680,3667
3068,"MARSABIT",75,258,201,459
3069,"MARSABIT",76,126,102,228
3070,"MARSABIT",77,100,76,176
3071,"MARSABIT",78,109,83,192
3072,"MARSABIT",79,110,136,246
3073,"MARSABIT","75-79",703,598,1301
3074,"MARSABIT",80,461,428,889
3075,"MARSABIT",81,106,125,231
3076,"MARSABIT",82,96,70,166
3077,"MARSABIT",83,53,51,104
3078,"MARSABIT",84,68,64,132
3079,"MARSABIT","80-84",784,738,1522
3080,"MARSABIT",85,90,67,157
3081,"MARSABIT",86,56,38,94
3082,"MARSABIT",87,47,39,86
3083,"MARSABIT",88,33,16,49
3084,"MARSABIT",89,58,73,131
3085,"MARSABIT","85-89",284,233,517
3086,"MARSABIT",90,170,127,297
3087,"MARSABIT",91,31,30,61
3088,"MARSABIT",92,34,22,56
3089,"MARSABIT",93,10,9,19
3090,"MARSABIT",94,17,16,33
3091,"MARSABIT","90-94",262,204,466
3092,"MARSABIT",95,22,21,43
3093,"MARSABIT",96,14,11,25
3094,"MARSABIT",97,9,6,15
3095,"MARSABIT",98,11,10,21
3096,"MARSABIT",99,10,6,16
3097,"MARSABIT","95-99",66,54,120
3098,"MARSABIT","100+",60,63,123
3099,"MARSABIT","Not Stated",4,2,6
3101,"MERU","Total",699532,707228,1406760
3102,"MERU",0,13770,13912,27682
3103,"MERU",1,15486,15262,30748
3104,"MERU",2,15577,15578,31155
3105,"MERU",3,16416,16452,32868
3106,"MERU",4,16069,15890,31959
3107,"MERU","0 - 4",77318,77094,154412
3108,"MERU",5,16270,15547,31817
3109,"MERU",6,16308,16087,32395
3110,"MERU",7,16291,15950,32241
3111,"MERU",8,15509,15791,31300
3112,"MERU",9,17320,17332,34652
3113,"MERU","5-9",81698,80707,162405
3114,"MERU",10,19111,18292,37403
3115,"MERU",11,16622,17046,33668
3116,"MERU",12,18984,18482,37466
3117,"MERU",13,19205,19313,38518
3118,"MERU",14,18248,17875,36123
3119,"MERU","10-14",92170,91008,183178
3120,"MERU",15,17463,17374,34837
3121,"MERU",16,15776,16164,31940
3122,"MERU",17,15876,15710,31586
3123,"MERU",18,13533,13724,27257
3124,"MERU",19,14284,14307,28591
3125,"MERU","15-19",76932,77279,154211
3126,"MERU",20,14145,14200,28345
3127,"MERU",21,10755,11175,21930
3128,"MERU",22,11320,11071,22391
3129,"MERU",23,11033,11167,22200
3130,"MERU",24,10089,9769,19858
3131,"MERU","20-24",57342,57382,114724
3132,"MERU",25,12075,11238,23313
3133,"MERU",26,8812,9008,17820
3134,"MERU",27,9796,9740,19536
3135,"MERU",28,8646,8519,17165
3136,"MERU",29,8603,8766,17369
3137,"MERU","25-29",47932,47271,95203
3138,"MERU",30,13824,13955,27779
3139,"MERU",31,8072,8190,16262
3140,"MERU",32,10160,11182,21342
3141,"MERU",33,9385,10540,19925
3142,"MERU",34,8032,8928,16960
3143,"MERU","30-34",49473,52795,102268
3144,"MERU",35,15222,15000,30222
3145,"MERU",36,7924,7709,15633
3146,"MERU",37,8802,7850,16652
3147,"MERU",38,6869,7014,13883
3148,"MERU",39,8383,7875,16258
3149,"MERU","35-39",47200,45448,92648
3150,"MERU",40,12577,11731,24308
3151,"MERU",41,8160,7007,15167
3152,"MERU",42,7489,6608,14097
3153,"MERU",43,6375,6382,12757
3154,"MERU",44,5980,5704,11684
3155,"MERU","40-44",40581,37432,78013
3156,"MERU",45,9409,9042,18451
3157,"MERU",46,6459,6313,12772
3158,"MERU",47,6281,6254,12535
3159,"MERU",48,4801,4881,9682
3160,"MERU",49,5851,5996,11847
3161,"MERU","45-49",32801,32486,65287
3162,"MERU",50,8062,8644,16706
3163,"MERU",51,4812,4258,9070
3164,"MERU",52,3698,3156,6854
3165,"MERU",53,2672,2497,5169
3166,"MERU",54,3355,3011,6366
3167,"MERU","50-54",22599,21566,44165
3168,"MERU",55,4683,4576,9259
3169,"MERU",56,5003,5017,10020
3170,"MERU",57,3734,4464,8198
3171,"MERU",58,3463,3736,7199
3172,"MERU",59,3910,4341,8251
3173,"MERU","55-59",20793,22134,42927
3174,"MERU",60,5851,6695,12546
3175,"MERU",61,3098,3285,6383
3176,"MERU",62,2879,2834,5713
3177,"MERU",63,2605,2794,5399
3178,"MERU",64,1851,2047,3898
3179,"MERU","60-64",16284,17655,33939
3180,"MERU",65,3726,4470,8196
3181,"MERU",66,1846,2035,3881
3182,"MERU",67,3352,3413,6765
3183,"MERU",68,1786,1728,3514
3184,"MERU",69,2615,3142,5757
3185,"MERU","65-69",13325,14788,28113
3186,"MERU",70,4531,6321,10852
3187,"MERU",71,1811,1981,3792
3188,"MERU",72,1796,1820,3616
3189,"MERU",73,1236,1361,2597
3190,"MERU",74,1135,1701,2836
3191,"MERU","70-74",10509,13184,23693
3192,"MERU",75,1437,1877,3314
3193,"MERU",76,775,827,1602
3194,"MERU",77,1126,1226,2352
3195,"MERU",78,829,788,1617
3196,"MERU",79,924,1769,2693
3197,"MERU","75-79",5091,6487,11578
3198,"MERU",80,1646,3157,4803
3199,"MERU",81,543,718,1261
3200,"MERU",82,525,550,1075
3201,"MERU",83,518,626,1144
3202,"MERU",84,547,840,1387
3203,"MERU","80-84",3779,5891,9670
3204,"MERU",85,608,889,1497
3205,"MERU",86,400,363,763
3206,"MERU",87,348,487,835
3207,"MERU",88,218,268,486
3208,"MERU",89,438,1108,1546
3209,"MERU","85-89",2012,3115,5127
3210,"MERU",90,442,1003,1445
3211,"MERU",91,151,279,430
3212,"MERU",92,106,169,275
3213,"MERU",93,96,152,248
3214,"MERU",94,104,240,344
3215,"MERU","90-94",899,1843,2742
3216,"MERU",95,165,303,468
3217,"MERU",96,63,104,167
3218,"MERU",97,97,113,210
3219,"MERU",98,64,88,152
3220,"MERU",99,113,286,399
3221,"MERU","95-99",502,894,1396
3222,"MERU","100+",281,757,1038
3223,"MERU","Not Stated",11,12,23
3225,"MIGORI","Total",455887,493318,949205
3226,"MIGORI",0,12382,12636,25018
3227,"MIGORI",1,13343,13446,26789
3228,"MIGORI",2,13417,13901,27318
3229,"MIGORI",3,14681,14803,29484
3230,"MIGORI",4,14828,14804,29632
3231,"MIGORI","0 - 4",68651,69590,138241
3232,"MIGORI",5,15274,15340,30614
3233,"MIGORI",6,15367,15525,30892
3234,"MIGORI",7,14255,14185,28440
3235,"MIGORI",8,14272,14646,28918
3236,"MIGORI",9,15518,15353,30871
3237,"MIGORI","5-9",74686,75049,149735
3238,"MIGORI",10,16930,17070,34000
3239,"MIGORI",11,14626,15170,29796
3240,"MIGORI",12,16963,16310,33273
3241,"MIGORI",13,15756,15761,31517
3242,"MIGORI",14,14491,13977,28468
3243,"MIGORI","10-14",78766,78288,157054
3244,"MIGORI",15,14118,13851,27969
3245,"MIGORI",16,12231,12076,24307
3246,"MIGORI",17,11566,11185,22751
3247,"MIGORI",18,9589,9448,19037
3248,"MIGORI",19,10641,11049,21690
3249,"MIGORI","15-19",58145,57609,115754
3250,"MIGORI",20,9290,11041,20331
3251,"MIGORI",21,7429,8931,16360
3252,"MIGORI",22,6786,8545,15331
3253,"MIGORI",23,7217,8688,15905
3254,"MIGORI",24,6461,7603,14064
3255,"MIGORI","20-24",37183,44808,81991
3256,"MIGORI",25,7714,8806,16520
3257,"MIGORI",26,5820,7262,13082
3258,"MIGORI",27,6127,7452,13579
3259,"MIGORI",28,4389,5669,10058
3260,"MIGORI",29,4309,5563,9872
3261,"MIGORI","25-29",28359,34752,63111
3262,"MIGORI",30,6522,8537,15059
3263,"MIGORI",31,4605,6033,10638
3264,"MIGORI",32,5363,7000,12363
3265,"MIGORI",33,4760,6166,10926
3266,"MIGORI",34,4366,5061,9427
3267,"MIGORI","30-34",25616,32797,58413
3268,"MIGORI",35,5888,6126,12014
3269,"MIGORI",36,4048,3672,7720
3270,"MIGORI",37,3937,3534,7471
3271,"MIGORI",38,2546,2471,5017
3272,"MIGORI",39,3157,2793,5950
3273,"MIGORI","35-39",19576,18596,38172
3274,"MIGORI",40,4108,4323,8431
3275,"MIGORI",41,3534,3602,7136
3276,"MIGORI",42,3228,3585,6813
3277,"MIGORI",43,3015,3276,6291
3278,"MIGORI",44,2337,2524,4861
3279,"MIGORI","40-44",16222,17310,33532
3280,"MIGORI",45,3641,3964,7605
3281,"MIGORI",46,2602,2968,5570
3282,"MIGORI",47,2904,3511,6415
3283,"MIGORI",48,1489,1906,3395
3284,"MIGORI",49,1868,2186,4054
3285,"MIGORI","45-49",12504,14535,27039
3286,"MIGORI",50,2411,3263,5674
3287,"MIGORI",51,1799,2268,4067
3288,"MIGORI",52,1391,1808,3199
3289,"MIGORI",53,1255,1472,2727
3290,"MIGORI",54,1534,1783,3317
3291,"MIGORI","50-54",8390,10594,18984
3292,"MIGORI",55,1642,2141,3783
3293,"MIGORI",56,1742,2315,4057
3294,"MIGORI",57,1675,2789,4464
3295,"MIGORI",58,1128,1422,2550
3296,"MIGORI",59,1296,1886,3182
3297,"MIGORI","55-59",7483,10553,18036
3298,"MIGORI",60,1911,2756,4667
3299,"MIGORI",61,1518,2029,3547
3300,"MIGORI",62,1119,1354,2473
3301,"MIGORI",63,1256,1456,2712
3302,"MIGORI",64,894,1247,2141
3303,"MIGORI","60-64",6698,8842,15540
3304,"MIGORI",65,1250,1840,3090
3305,"MIGORI",66,888,1152,2040
3306,"MIGORI",67,1303,1949,3252
3307,"MIGORI",68,552,720,1272
3308,"MIGORI",69,913,1325,2238
3309,"MIGORI","65-69",4906,6986,11892
3310,"MIGORI",70,1219,1950,3169
3311,"MIGORI",71,829,1067,1896
3312,"MIGORI",72,698,783,1481
3313,"MIGORI",73,529,654,1183
3314,"MIGORI",74,544,811,1355
3315,"MIGORI","70-74",3819,5265,9084
3316,"MIGORI",75,495,745,1240
3317,"MIGORI",76,401,586,987
3318,"MIGORI",77,553,806,1359
3319,"MIGORI",78,263,352,615
3320,"MIGORI",79,359,742,1101
3321,"MIGORI","75-79",2071,3231,5302
3322,"MIGORI",80,412,840,1252
3323,"MIGORI",81,309,451,760
3324,"MIGORI",82,281,337,618
3325,"MIGORI",83,257,338,595
3326,"MIGORI",84,218,374,592
3327,"MIGORI","80-84",1477,2340,3817
3328,"MIGORI",85,201,322,523
3329,"MIGORI",86,158,186,344
3330,"MIGORI",87,243,338,581
3331,"MIGORI",88,85,153,238
3332,"MIGORI",89,153,356,509
3333,"MIGORI","85-89",840,1355,2195
3334,"MIGORI",90,107,189,296
3335,"MIGORI",91,75,104,179
3336,"MIGORI",92,47,52,99
3337,"MIGORI",93,34,53,87
3338,"MIGORI",94,29,64,93
3339,"MIGORI","90-94",292,462,754
3340,"MIGORI",95,54,94,148
3341,"MIGORI",96,28,35,63
3342,"MIGORI",97,17,36,53
3343,"MIGORI",98,11,24,35
3344,"MIGORI",99,21,48,69
3345,"MIGORI","95-99",131,237,368
3346,"MIGORI","100+",67,107,174
3347,"MIGORI","Not Stated",5,12,17
3349,"MOMBASA","Total",610257,598046,1208303
3350,"MOMBASA",0,15111,15009,30120
3351,"MOMBASA",1,15805,15308,31113
3352,"MOMBASA",2,15088,14837,29925
3353,"MOMBASA",3,14660,14031,28691
3354,"MOMBASA",4,14061,13993,28054
3355,"MOMBASA","0 - 4",74725,73178,147903
3356,"MOMBASA",5,13851,14023,27874
3357,"MOMBASA",6,12889,13216,26105
3358,"MOMBASA",7,13268,13203,26471
3359,"MOMBASA",8,11996,12423,24419
3360,"MOMBASA",9,12523,12594,25117
3361,"MOMBASA","5 - 9",64527,65459,129986
3362,"MOMBASA",10,12349,12343,24692
3363,"MOMBASA",11,11115,11497,22612
3364,"MOMBASA",12,11661,11630,23291
3365,"MOMBASA",13,11631,12081,23712
3366,"MOMBASA",14,10388,10729,21117
3367,"MOMBASA","10-14",57144,58280,115424
3368,"MOMBASA",15,9199,9724,18923
3369,"MOMBASA",16,8922,9863,18785
3370,"MOMBASA",17,9863,10487,20350
3371,"MOMBASA",18,8964,10217,19181
3372,"MOMBASA",19,10596,12898,23494
3373,"MOMBASA","15-19",47544,53189,100733
3374,"MOMBASA",20,11186,14416,25602
3375,"MOMBASA",21,11527,13706,25233
3376,"MOMBASA",22,12833,15192,28025
3377,"MOMBASA",23,14195,16513,30708
3378,"MOMBASA",24,14081,16084,30165
3379,"MOMBASA","20-24",63822,75911,139733
3380,"MOMBASA",25,16231,16675,32906
3381,"MOMBASA",26,14231,15107,29338
3382,"MOMBASA",27,14111,14768,28879
3383,"MOMBASA",28,12333,13049,25382
3384,"MOMBASA",29,12921,13202,26123
3385,"MOMBASA","25-29",69827,72801,142628
3386,"MOMBASA",30,15982,16319,32301
3387,"MOMBASA",31,10866,10548,21414
3388,"MOMBASA",32,13578,13379,26957
3389,"MOMBASA",33,10592,10562,21154
3390,"MOMBASA",34,10335,10056,20391
3391,"MOMBASA","30-34",61353,60864,122217
3392,"MOMBASA",35,12644,11396,24040
3393,"MOMBASA",36,9495,8491,17986
3394,"MOMBASA",37,9167,8165,17332
3395,"MOMBASA",38,7666,6978,14644
3396,"MOMBASA",39,8106,7005,15111
3397,"MOMBASA","35-39",47078,42035,89113
3398,"MOMBASA",40,10190,8555,18745
3399,"MOMBASA",41,8490,6541,15031
3400,"MOMBASA",42,8405,6505,14910
3401,"MOMBASA",43,6979,5521,12500
3402,"MOMBASA",44,6034,4598,10632
3403,"MOMBASA","40-44",40098,31720,71818
3404,"MOMBASA",45,8759,6234,14993
3405,"MOMBASA",46,5852,4342,10194
3406,"MOMBASA",47,6402,4282,10684
3407,"MOMBASA",48,4607,3406,8013
3408,"MOMBASA",49,5045,3338,8383
3409,"MOMBASA","45-49",30665,21602,52267
3410,"MOMBASA",50,6027,4430,10457
3411,"MOMBASA",51,4139,2577,6716
3412,"MOMBASA",52,3674,2567,6241
3413,"MOMBASA",53,2788,1911,4699
3414,"MOMBASA",54,3227,2117,5344
3415,"MOMBASA","50-54",19855,13602,33457
3416,"MOMBASA",55,3158,2059,5217
3417,"MOMBASA",56,3259,2366,5625
3418,"MOMBASA",57,2881,2099,4980
3419,"MOMBASA",58,2170,1769,3939
3420,"MOMBASA",59,2403,1908,4311
3421,"MOMBASA","55-59",13871,10201,24072
3422,"MOMBASA",60,2538,2356,4894
3423,"MOMBASA",61,1794,1444,3238
3424,"MOMBASA",62,1617,1274,2891
3425,"MOMBASA",63,1462,1273,2735
3426,"MOMBASA",64,1238,1038,2276
3427,"MOMBASA","60-64",8649,7385,16034
3428,"MOMBASA",65,1555,1434,2989
3429,"MOMBASA",66,1007,856,1863
3430,"MOMBASA",67,1229,994,2223
3431,"MOMBASA",68,721,682,1403
3432,"MOMBASA",69,879,886,1765
3433,"MOMBASA","65-69",5391,4852,10243
3434,"MOMBASA",70,1027,1265,2292
3435,"MOMBASA",71,624,618,1242
3436,"MOMBASA",72,574,518,1092
3437,"MOMBASA",73,464,446,910
3438,"MOMBASA",74,387,472,859
3439,"MOMBASA","70-74",3076,3319,6395
3440,"MOMBASA",75,430,500,930
3441,"MOMBASA",76,280,315,595
3442,"MOMBASA",77,263,263,526
3443,"MOMBASA",78,222,221,443
3444,"MOMBASA",79,241,310,551
3445,"MOMBASA","75-79",1436,1609,3045
3446,"MOMBASA",80,234,493,727
3447,"MOMBASA",81,130,178,308
3448,"MOMBASA",82,138,156,294
3449,"MOMBASA",83,128,144,272
3450,"MOMBASA",84,92,165,257
3451,"MOMBASA","80-84",722,1136,1858
3452,"MOMBASA",85,88,171,259
3453,"MOMBASA",86,65,82,147
3454,"MOMBASA",87,59,70,129
3455,"MOMBASA",88,30,57,87
3456,"MOMBASA",89,52,129,181
3457,"MOMBASA","85-89",294,509,803
3458,"MOMBASA",90,39,107,146
3459,"MOMBASA",91,17,38,55
3460,"MOMBASA",92,19,26,45
3461,"MOMBASA",93,12,24,36
3462,"MOMBASA",94,11,30,41
3463,"MOMBASA","90-94",98,225,323
3464,"MOMBASA",95,11,41,52
3465,"MOMBASA",96,13,17,30
3466,"MOMBASA",97,9,12,21
3467,"MOMBASA",98,8,7,15
3468,"MOMBASA",99,13,21,34
3469,"MOMBASA","95-99",54,98,152
3470,"MOMBASA","100+",14,59,73
3471,"MOMBASA","Not Stated",14,12,26
3473,"MURANG'A","Total",467062,471121,938183
3474,"MURANG'A",0,9280,8940,18220
3475,"MURANG'A",1,9471,9306,18777
3476,"MURANG'A",2,9745,9437,19182
3477,"MURANG'A",3,9827,10060,19887
3478,"MURANG'A",4,10348,10117,20465
3479,"MURANG'A","0 - 4",48671,47860,96531
3480,"MURANG'A",5,10023,9665,19688
3481,"MURANG'A",6,9971,9940,19911
3482,"MURANG'A",7,10436,10225,20661
3483,"MURANG'A",8,10179,9919,20098
3484,"MURANG'A",9,11192,11041,22233
3485,"MURANG'A","5-9",51801,50790,102591
3486,"MURANG'A",10,10815,10436,21251
3487,"MURANG'A",11,10066,10116,20182
3488,"MURANG'A",12,11146,10610,21756
3489,"MURANG'A",13,11344,10931,22275
3490,"MURANG'A",14,11164,10211,21375
3491,"MURANG'A","10-14",54535,52304,106839
3492,"MURANG'A",15,10904,10127,21031
3493,"MURANG'A",16,10667,9959,20626
3494,"MURANG'A",17,11064,9655,20719
3495,"MURANG'A",18,9138,7722,16860
3496,"MURANG'A",19,8738,7217,15955
3497,"MURANG'A","15-19",50511,44680,95191
3498,"MURANG'A",20,7528,6657,14185
3499,"MURANG'A",21,6699,6071,12770
3500,"MURANG'A",22,6422,5906,12328
3501,"MURANG'A",23,6297,6085,12382
3502,"MURANG'A",24,5623,5423,11046
3503,"MURANG'A","20-24",32569,30142,62711
3504,"MURANG'A",25,5691,5509,11200
3505,"MURANG'A",26,4899,5017,9916
3506,"MURANG'A",27,5359,5287,10646
3507,"MURANG'A",28,4847,5119,9966
3508,"MURANG'A",29,5358,5567,10925
3509,"MURANG'A","25-29",26154,26499,52653
3510,"MURANG'A",30,6768,6749,13517
3511,"MURANG'A",31,5247,5190,10437
3512,"MURANG'A",32,6465,6740,13205
3513,"MURANG'A",33,5858,6090,11948
3514,"MURANG'A",34,5611,5666,11277
3515,"MURANG'A","30-34",29949,30435,60384
3516,"MURANG'A",35,7361,7317,14678
3517,"MURANG'A",36,5650,5776,11426
3518,"MURANG'A",37,5935,5585,11520
3519,"MURANG'A",38,5219,5409,10628
3520,"MURANG'A",39,5874,5660,11534
3521,"MURANG'A","35-39",30039,29747,59786
3522,"MURANG'A",40,7041,6770,13811
3523,"MURANG'A",41,5905,5509,11414
3524,"MURANG'A",42,5758,5539,11297
3525,"MURANG'A",43,5091,4950,10041
3526,"MURANG'A",44,4713,4571,9284
3527,"MURANG'A","40-44",28508,27339,55847
3528,"MURANG'A",45,6469,6340,12809
3529,"MURANG'A",46,5198,5030,10228
3530,"MURANG'A",47,5428,5361,10789
3531,"MURANG'A",48,4259,4230,8489
3532,"MURANG'A",49,4324,4485,8809
3533,"MURANG'A","45-49",25678,25446,51124
3534,"MURANG'A",50,4882,5303,10185
3535,"MURANG'A",51,3915,3923,7838
3536,"MURANG'A",52,4238,4607,8845
3537,"MURANG'A",53,3225,3552,6777
3538,"MURANG'A",54,3750,3987,7737
3539,"MURANG'A","50-54",20010,21372,41382
3540,"MURANG'A",55,4144,4201,8345
3541,"MURANG'A",56,4436,4581,9017
3542,"MURANG'A",57,3584,4317,7901
3543,"MURANG'A",58,2931,3468,6399
3544,"MURANG'A",59,3457,3798,7255
3545,"MURANG'A","55-59",18552,20365,38917
3546,"MURANG'A",60,3812,4269,8081
3547,"MURANG'A",61,3033,3411,6444
3548,"MURANG'A",62,2704,2747,5451
3549,"MURANG'A",63,2265,2493,4758
3550,"MURANG'A",64,1835,1918,3753
3551,"MURANG'A","60-64",13649,14838,28487
3552,"MURANG'A",65,2789,3183,5972
3553,"MURANG'A",66,2017,2320,4337
3554,"MURANG'A",67,3640,3999,7639
3555,"MURANG'A",68,1683,1826,3509
3556,"MURANG'A",69,2503,2788,5291
3557,"MURANG'A","65-69",12632,14116,26748
3558,"MURANG'A",70,3120,4240,7360
3559,"MURANG'A",71,2250,2550,4800
3560,"MURANG'A",72,2226,2072,4298
3561,"MURANG'A",73,1841,1787,3628
3562,"MURANG'A",74,1584,1932,3516
3563,"MURANG'A","70-74",11021,12581,23602
3564,"MURANG'A",75,1333,1901,3234
3565,"MURANG'A",76,1474,2874,4348
3566,"MURANG'A",77,1075,1529,2604
3567,"MURANG'A",78,760,913,1673
3568,"MURANG'A",79,953,1624,2577
3569,"MURANG'A","75-79",5595,8841,14436
3570,"MURANG'A",80,1129,2093,3222
3571,"MURANG'A",81,599,1078,1677
3572,"MURANG'A",82,617,776,1393
3573,"MURANG'A",83,713,962,1675
3574,"MURANG'A",84,613,1143,1756
3575,"MURANG'A","80-84",3671,6052,9723
3576,"MURANG'A",85,562,980,1542
3577,"MURANG'A",86,420,693,1113
3578,"MURANG'A",87,467,729,1196
3579,"MURANG'A",88,233,356,589
3580,"MURANG'A",89,401,1091,1492
3581,"MURANG'A","85-89",2083,3849,5932
3582,"MURANG'A",90,248,679,927
3583,"MURANG'A",91,250,481,731
3584,"MURANG'A",92,140,288,428
3585,"MURANG'A",93,118,273,391
3586,"MURANG'A",94,90,315,405
3587,"MURANG'A","90-94",846,2036,2882
3588,"MURANG'A",95,134,331,465
3589,"MURANG'A",96,77,185,262
3590,"MURANG'A",97,89,209,298
3591,"MURANG'A",98,63,138,201
3592,"MURANG'A",99,72,298,370
3593,"MURANG'A","95-99",435,1161,1596
3594,"MURANG'A","100+",146,663,809
3595,"MURANG'A","Not Stated",7,5,12
3597,"NAKURU","Total",559639,555458,1115097
3598,"NAKURU",0,13336,13151,26487
3599,"NAKURU",1,13782,13488,27270
3600,"NAKURU",2,14325,14014,28339
3601,"NAKURU",3,15208,15063,30271
3602,"NAKURU",4,15799,15031,30830
3603,"NAKURU","0 - 4",72450,70747,143197
3604,"NAKURU",5,15436,14627,30063
3605,"NAKURU",6,15044,14864,29908
3606,"NAKURU",7,16039,15244,31283
3607,"NAKURU",8,14435,14282,28717
3608,"NAKURU",9,16784,16053,32837
3609,"NAKURU","5-9",77738,75070,152808
3610,"NAKURU",10,16763,16063,32826
3611,"NAKURU",11,15232,15060,30292
3612,"NAKURU",12,17526,16457,33983
3613,"NAKURU",13,16831,16484,33315
3614,"NAKURU",14,16389,15384,31773
3615,"NAKURU","10-19",82741,79448,162189
3616,"NAKURU",15,16097,14877,30974
3617,"NAKURU",16,14631,13573,28204
3618,"NAKURU",17,14681,13237,27918
3619,"NAKURU",18,11229,10047,21276
3620,"NAKURU",19,12586,11415,24001
3621,"NAKURU","15-19",69224,63149,132373
3622,"NAKURU",20,10352,10001,20353
3623,"NAKURU",21,9847,9508,19355
3624,"NAKURU",22,9213,9095,18308
3625,"NAKURU",23,9147,9304,18451
3626,"NAKURU",24,8082,8095,16177
3627,"NAKURU","20-24",46641,46003,92644
3628,"NAKURU",25,8439,8724,17163
3629,"NAKURU",26,6744,7186,13930
3630,"NAKURU",27,7506,7891,15397
3631,"NAKURU",28,5616,6261,11877
3632,"NAKURU",29,6525,7152,13677
3633,"NAKURU","25-29",34830,37214,72044
3634,"NAKURU",30,8011,9040,17051
3635,"NAKURU",31,5988,6578,12566
3636,"NAKURU",32,7495,8415,15910
3637,"NAKURU",33,6440,7324,13764
3638,"NAKURU",34,5987,6568,12555
3639,"NAKURU","30-34",33921,37925,71846
3640,"NAKURU",35,8458,8648,17106
3641,"NAKURU",36,5428,5298,10726
3642,"NAKURU",37,5732,5245,10977
3643,"NAKURU",38,4093,4104,8197
3644,"NAKURU",39,4999,4710,9709
3645,"NAKURU","35-39",28710,28005,56715
3646,"NAKURU",40,6171,5691,11862
3647,"NAKURU",41,6684,5997,12681
3648,"NAKURU",42,5502,4979,10481
3649,"NAKURU",43,4387,4537,8924
3650,"NAKURU",44,3553,3633,7186
3651,"NAKURU","40-44",26297,24837,51134
3652,"NAKURU",45,6763,6279,13042
3653,"NAKURU",46,4257,4342,8599
3654,"NAKURU",47,4884,4780,9664
3655,"NAKURU",48,3292,3187,6479
3656,"NAKURU",49,3971,4033,8004
3657,"NAKURU","45-49",23167,22621,45788
3658,"NAKURU",50,4427,4591,9018
3659,"NAKURU",51,3566,3620,7186
3660,"NAKURU",52,3305,3168,6473
3661,"NAKURU",53,2312,2462,4774
3662,"NAKURU",54,2817,2848,5665
3663,"NAKURU","50-54",16427,16689,33116
3664,"NAKURU",55,2977,2967,5944
3665,"NAKURU",56,3060,3193,6253
3666,"NAKURU",57,2513,2919,5432
3667,"NAKURU",58,2676,3384,6060
3668,"NAKURU",59,2721,2779,5500
3669,"NAKURU","55-59",13947,15242,29189
3670,"NAKURU",60,3000,3211,6211
3671,"NAKURU",61,2246,2414,4660
3672,"NAKURU",62,1929,1923,3852
3673,"NAKURU",63,1682,1822,3504
3674,"NAKURU",64,1261,1454,2715
3675,"NAKURU","60-64",10118,10824,20942
3676,"NAKURU",65,2171,2301,4472
3677,"NAKURU",66,1417,1398,2815
3678,"NAKURU",67,2400,2458,4858
3679,"NAKURU",68,1057,1058,2115
3680,"NAKURU",69,1684,1759,3443
3681,"NAKURU","65-69",8729,8974,17703
3682,"NAKURU",70,2010,2471,4481
3683,"NAKURU",71,1503,1441,2944
3684,"NAKURU",72,1307,1073,2380
3685,"NAKURU",73,1031,1019,2050
3686,"NAKURU",74,892,1114,2006
3687,"NAKURU","70-74",6743,7118,13861
3688,"NAKURU",75,820,1187,2007
3689,"NAKURU",76,888,1372,2260
3690,"NAKURU",77,738,795,1533
3691,"NAKURU",78,473,555,1028
3692,"NAKURU",79,617,943,1560
3693,"NAKURU","75-79",3536,4852,8388
3694,"NAKURU",80,693,1108,1801
3695,"NAKURU",81,415,512,927
3696,"NAKURU",82,393,380,773
3697,"NAKURU",83,396,470,866
3698,"NAKURU",84,413,571,984
3699,"NAKURU","80-84",2310,3041,5351
3700,"NAKURU",85,304,481,785
3701,"NAKURU",86,202,382,584
3702,"NAKURU",87,267,348,615
3703,"NAKURU",88,166,193,359
3704,"NAKURU",89,287,531,818
3705,"NAKURU","85-89",1226,1935,3161
3706,"NAKURU",90,167,348,515
3707,"NAKURU",91,130,216,346
3708,"NAKURU",92,77,120,197
3709,"NAKURU",93,63,111,174
3710,"NAKURU",94,50,124,174
3711,"NAKURU","90-94",487,919,1406
3712,"NAKURU",95,90,166,256
3713,"NAKURU",96,51,82,133
3714,"NAKURU",97,65,89,154
3715,"NAKURU",98,40,62,102
3716,"NAKURU",99,55,126,181
3717,"NAKURU","95-99",301,525,826
3718,"NAKURU","100+",87,314,401
3719,"NAKURU","Not Stated",8,6,14
3721,"NANDI","Total",411715,414497,826212
3722,"NANDI",0,9239,8945,18184
3723,"NANDI",1,9663,9589,19252
3724,"NANDI",2,9940,9856,19796
3725,"NANDI",3,10243,10382,20625
3726,"NANDI",4,10697,10398,21095
3727,"NANDI","0 - 4",49782,49170,98952
3728,"NANDI",5,10612,10273,20885
3729,"NANDI",6,10557,10729,21286
3730,"NANDI",7,11222,10875,22097
3731,"NANDI",8,10910,10653,21563
3732,"NANDI",9,12047,11973,24020
3733,"NANDI","5-9",55348,54503,109851
3734,"NANDI",10,11882,11245,23127
3735,"NANDI",11,11458,11713,23171
3736,"NANDI",12,12863,12342,25205
3737,"NANDI",13,12508,12332,24840
3738,"NANDI",14,11952,11554,23506
3739,"NANDI","10-14",60663,59186,119849
3740,"NANDI",15,11657,11353,23010
3741,"NANDI",16,10957,10556,21513
3742,"NANDI",17,11192,10609,21801
3743,"NANDI",18,8795,8314,17109
3744,"NANDI",19,9991,9241,19232
3745,"NANDI","15-19",52592,50073,102665
3746,"NANDI",20,8214,8184,16398
3747,"NANDI",21,7749,7749,15498
3748,"NANDI",22,6893,7192,14085
3749,"NANDI",23,6894,7749,14643
3750,"NANDI",24,6149,6628,12777
3751,"NANDI","20-24",35899,37502,73401
3752,"NANDI",25,6587,6967,13554
3753,"NANDI",26,5423,6293,11716
3754,"NANDI",27,5921,6463,12384
3755,"NANDI",28,4366,5071,9437
3756,"NANDI",29,5333,6130,11463
3757,"NANDI","25-29",27630,30924,58554
3758,"NANDI",30,5964,6748,12712
3759,"NANDI",31,5068,5719,10787
3760,"NANDI",32,6141,7057,13198
3761,"NANDI",33,5574,6587,12161
3762,"NANDI",34,4860,5432,10292
3763,"NANDI","30-34",27607,31543,59150
3764,"NANDI",35,6105,6133,12238
3765,"NANDI",36,4222,3594,7816
3766,"NANDI",37,4507,3664,8171
3767,"NANDI",38,3060,2556,5616
3768,"NANDI",39,3981,3391,7372
3769,"NANDI","35-39",21875,19338,41213
3770,"NANDI",40,3951,3671,7622
3771,"NANDI",41,4392,3868,8260
3772,"NANDI",42,4103,3774,7877
3773,"NANDI",43,3868,3962,7830
3774,"NANDI",44,3148,3011,6159
3775,"NANDI","40-44",19462,18286,37748
3776,"NANDI",45,4455,4128,8583
3777,"NANDI",46,3414,3246,6660
3778,"NANDI",47,3452,3415,6867
3779,"NANDI",48,2159,2150,4309
3780,"NANDI",49,2949,2986,5935
3781,"NANDI","45-49",16429,15925,32354
3782,"NANDI",50,2731,2819,5550
3783,"NANDI",51,2562,2565,5127
3784,"NANDI",52,2009,2123,4132
3785,"NANDI",53,1737,1925,3662
3786,"NANDI",54,1942,1846,3788
3787,"NANDI","50-54",10981,11278,22259
3788,"NANDI",55,2056,1737,3793
3789,"NANDI",56,1885,1875,3760
3790,"NANDI",57,1872,2463,4335
3791,"NANDI",58,1877,2336,4213
3792,"NANDI",59,2036,2105,4141
3793,"NANDI","55-59",9726,10516,20242
3794,"NANDI",60,2077,2071,4148
3795,"NANDI",61,1741,1685,3426
3796,"NANDI",62,1411,1309,2720
3797,"NANDI",63,1328,1471,2799
3798,"NANDI",64,1056,1101,2157
3799,"NANDI","60-64",7613,7637,15250
3800,"NANDI",65,1524,1662,3186
3801,"NANDI",66,877,1018,1895
3802,"NANDI",67,1598,1650,3248
3803,"NANDI",68,650,718,1368
3804,"NANDI",69,1137,1297,2434
3805,"NANDI","65-69",5786,6345,12131
3806,"NANDI",70,1135,1400,2535
3807,"NANDI",71,1009,1007,2016
3808,"NANDI",72,783,700,1483
3809,"NANDI",73,646,667,1313
3810,"NANDI",74,612,752,1364
3811,"NANDI","70-74",4185,4526,8711
3812,"NANDI",75,654,727,1381
3813,"NANDI",76,621,742,1363
3814,"NANDI",77,636,623,1259
3815,"NANDI",78,310,322,632
3816,"NANDI",79,466,719,1185
3817,"NANDI","75-79",2687,3133,5820
3818,"NANDI",80,486,641,1127
3819,"NANDI",81,281,345,626
3820,"NANDI",82,294,224,518
3821,"NANDI",83,330,336,666
3822,"NANDI",84,246,355,601
3823,"NANDI","80-84",1637,1901,3538
3824,"NANDI",85,216,272,488
3825,"NANDI",86,213,219,432
3826,"NANDI",87,209,268,477
3827,"NANDI",88,105,121,226
3828,"NANDI",89,222,458,680
3829,"NANDI","85-89",965,1338,2303
3830,"NANDI",90,129,213,342
3831,"NANDI",91,96,144,240
3832,"NANDI",92,82,95,177
3833,"NANDI",93,88,90,178
3834,"NANDI",94,70,118,188
3835,"NANDI","90-94",465,660,1125
3836,"NANDI",95,140,206,346
3837,"NANDI",96,37,38,75
3838,"NANDI",97,51,62,113
3839,"NANDI",98,26,44,70
3840,"NANDI",99,52,132,184
3841,"NANDI","95-99",306,482,788
3842,"NANDI","100+",77,229,306
3843,"NANDI","Not Stated","-",2,2
3845,"NAROK","Total",529224,528276,1057500
3846,"NAROK",0,14913,14860,29773
3847,"NAROK",1,16043,15630,31673
3848,"NAROK",2,17507,17347,34854
3849,"NAROK",3,19043,19072,38115
3850,"NAROK",4,20200,19785,39985
3851,"NAROK","0 - 4",87706,86694,174400
3852,"NAROK",5,20155,19353,39508
3853,"NAROK",6,20099,19690,39789
3854,"NAROK",7,18356,18262,36618
3855,"NAROK",8,18681,18246,36927
3856,"NAROK",9,17437,17052,34489
3857,"NAROK","5-9",94728,92603,187331
3858,"NAROK",10,20888,19958,40846
3859,"NAROK",11,14669,14947,29616
3860,"NAROK",12,19071,17469,36540
3861,"NAROK",13,16176,15692,31868
3862,"NAROK",14,15011,14676,29687
3863,"NAROK","10-14",85815,82742,168557
3864,"NAROK",15,15423,14375,29798
3865,"NAROK",16,12486,11347,23833
3866,"NAROK",17,12087,10149,22236
3867,"NAROK",18,10313,9150,19463
3868,"NAROK",19,10464,10159,20623
3869,"NAROK","15-19",60773,55180,115953
3870,"NAROK",20,10747,12225,22972
3871,"NAROK",21,7763,8808,16571
3872,"NAROK",22,8445,9383,17828
3873,"NAROK",23,7953,8562,16515
3874,"NAROK",24,7269,7594,14863
3875,"NAROK","20-24",42177,46572,88749
3876,"NAROK",25,9025,9818,18843
3877,"NAROK",26,6464,7357,13821
3878,"NAROK",27,6777,7632,14409
3879,"NAROK",28,5711,6804,12515
3880,"NAROK",29,5337,6215,11552
3881,"NAROK","25-29",33314,37826,71140
3882,"NAROK",30,9084,10313,19397
3883,"NAROK",31,4799,5572,10371
3884,"NAROK",32,6592,7159,13751
3885,"NAROK",33,4941,5596,10537
3886,"NAROK",34,4559,4351,8910
3887,"NAROK","30-34",29975,32991,62966
3888,"NAROK",35,7799,7393,15192
3889,"NAROK",36,3716,3215,6931
3890,"NAROK",37,4228,3693,7921
3891,"NAROK",38,2968,2725,5693
3892,"NAROK",39,3223,2815,6038
3893,"NAROK","35-39",21934,19841,41775
3894,"NAROK",40,5409,5093,10502
3895,"NAROK",41,4265,4284,8549
3896,"NAROK",42,3939,3736,7675
3897,"NAROK",43,2947,3034,5981
3898,"NAROK",44,2214,2192,4406
3899,"NAROK","40-44",18774,18339,37113
3900,"NAROK",45,5235,4879,10114
3901,"NAROK",46,3001,2849,5850
3902,"NAROK",47,3296,3372,6668
3903,"NAROK",48,2030,1758,3788
3904,"NAROK",49,2326,2370,4696
3905,"NAROK","45-49",15888,15228,31116
3906,"NAROK",50,3837,4127,7964
3907,"NAROK",51,1987,1966,3953
3908,"NAROK",52,1865,1708,3573
3909,"NAROK",53,1350,1214,2564
3910,"NAROK",54,1688,1538,3226
3911,"NAROK","50-54",10727,10553,21280
3912,"NAROK",55,1843,1837,3680
3913,"NAROK",56,1680,1637,3317
3914,"NAROK",57,1373,1448,2821
3915,"NAROK",58,1617,2107,3724
3916,"NAROK",59,1465,1788,3253
3917,"NAROK","55-59",7978,8817,16795
3918,"NAROK",60,2446,2712,5158
3919,"NAROK",61,1137,1297,2434
3920,"NAROK",62,1064,1009,2073
3921,"NAROK",63,1020,1205,2225
3922,"NAROK",64,804,790,1594
3923,"NAROK","60-64",6471,7013,13484
3924,"NAROK",65,1554,1557,3111
3925,"NAROK",66,605,475,1080
3926,"NAROK",67,1139,954,2093
3927,"NAROK",68,523,513,1036
3928,"NAROK",69,865,929,1794
3929,"NAROK","65-69",4686,4428,9114
3930,"NAROK",70,1374,1807,3181
3931,"NAROK",71,693,654,1347
3932,"NAROK",72,593,524,1117
3933,"NAROK",73,494,452,946
3934,"NAROK",74,528,587,1115
3935,"NAROK","70-74",3682,4024,7706
3936,"NAROK",75,606,661,1267
3937,"NAROK",76,347,320,667
3938,"NAROK",77,360,343,703
3939,"NAROK",78,276,235,511
3940,"NAROK",79,415,503,918
3941,"NAROK","75-79",2004,2062,4066
3942,"NAROK",80,564,821,1385
3943,"NAROK",81,210,213,423
3944,"NAROK",82,186,159,345
3945,"NAROK",83,157,155,312
3946,"NAROK",84,180,257,437
3947,"NAROK","80-84",1297,1605,2902
3948,"NAROK",85,192,219,411
3949,"NAROK",86,93,104,197
3950,"NAROK",87,128,151,279
3951,"NAROK",88,69,75,144
3952,"NAROK",89,179,275,454
3953,"NAROK","85-89",661,824,1485
3954,"NAROK",90,127,242,369
3955,"NAROK",91,46,54,100
3956,"NAROK",92,52,48,100
3957,"NAROK",93,38,41,79
3958,"NAROK",94,54,59,113
3959,"NAROK","90-94",317,444,761
3960,"NAROK",95,78,103,181
3961,"NAROK",96,19,32,51
3962,"NAROK",97,34,26,60
3963,"NAROK",98,21,28,49
3964,"NAROK",99,43,62,105
3965,"NAROK","95-99",195,251,446
3966,"NAROK","100+",116,236,352
3967,"NAROK","Not Stated",6,3,9
3969,"NYAMIRA","Total",268241,290286,558527
3970,"NYAMIRA",0,5200,5365,10565
3971,"NYAMIRA",1,5549,5568,11117
3972,"NYAMIRA",2,5848,5804,11652
3973,"NYAMIRA",3,6283,6340,12623
3974,"NYAMIRA",4,6727,6539,13266
3975,"NYAMIRA","0-4",29607,29616,59223
3976,"NYAMIRA",5,6800,6744,13544
3977,"NYAMIRA",6,7160,7203,14363
3978,"NYAMIRA",7,7477,7250,14727
3979,"NYAMIRA",8,7181,7106,14287
3980,"NYAMIRA",9,8291,8149,16440
3981,"NYAMIRA","5-9",36909,36452,73361
3982,"NYAMIRA",10,9234,8964,18198
3983,"NYAMIRA",11,7857,8127,15984
3984,"NYAMIRA",12,9841,9253,19094
3985,"NYAMIRA",13,8948,8941,17889
3986,"NYAMIRA",14,8340,7916,16256
3987,"NYAMIRA","10-14",44220,43201,87421
3988,"NYAMIRA",15,7877,7734,15611
3989,"NYAMIRA",16,7164,6990,14154
3990,"NYAMIRA",17,6852,6924,13776
3991,"NYAMIRA",18,5400,5233,10633
3992,"NYAMIRA",19,5588,5414,11002
3993,"NYAMIRA","15-19",32881,32295,65176
3994,"NYAMIRA",20,4470,4912,9382
3995,"NYAMIRA",21,3586,4230,7816
3996,"NYAMIRA",22,3396,4135,7531
3997,"NYAMIRA",23,3343,4359,7702
3998,"NYAMIRA",24,3186,4168,7354
3999,"NYAMIRA","20-24",17981,21804,39785
4000,"NYAMIRA",25,4039,5151,9190
4001,"NYAMIRA",26,2875,4172,7047
4002,"NYAMIRA",27,3255,4506,7761
4003,"NYAMIRA",28,2672,3629,6301
4004,"NYAMIRA",29,2764,4092,6856
4005,"NYAMIRA","25-29",15605,21550,37155
4006,"NYAMIRA",30,4129,6196,10325
4007,"NYAMIRA",31,3032,4823,7855
4008,"NYAMIRA",32,3534,5397,8931
4009,"NYAMIRA",33,3024,4441,7465
4010,"NYAMIRA",34,2818,3909,6727
4011,"NYAMIRA","30-34",16537,24766,41303
4012,"NYAMIRA",35,4027,4618,8645
4013,"NYAMIRA",36,2573,2519,5092
4014,"NYAMIRA",37,2648,2542,5190
4015,"NYAMIRA",38,2039,2066,4105
4016,"NYAMIRA",39,2465,2391,4856
4017,"NYAMIRA","35-39",13752,14136,27888
4018,"NYAMIRA",40,3088,3355,6443
4019,"NYAMIRA",41,3337,3195,6532
4020,"NYAMIRA",42,2369,2530,4899
4021,"NYAMIRA",43,2311,2551,4862
4022,"NYAMIRA",44,1779,2003,3782
4023,"NYAMIRA","40-44",12884,13634,26518
4024,"NYAMIRA",45,3219,3527,6746
4025,"NYAMIRA",46,2047,2493,4540
4026,"NYAMIRA",47,2249,2607,4856
4027,"NYAMIRA",48,1410,1532,2942
4028,"NYAMIRA",49,1669,2047,3716
4029,"NYAMIRA","45-49",10594,12206,22800
4030,"NYAMIRA",50,2176,2469,4645
4031,"NYAMIRA",51,1734,1655,3389
4032,"NYAMIRA",52,1253,1152,2405
4033,"NYAMIRA",53,1118,903,2021
4034,"NYAMIRA",54,1318,1089,2407
4035,"NYAMIRA","50-54",7599,7268,14867
4036,"NYAMIRA",55,1642,1449,3091
4037,"NYAMIRA",56,1894,1945,3839
4038,"NYAMIRA",57,2169,2545,4714
4039,"NYAMIRA",58,1398,1536,2934
4040,"NYAMIRA",59,2101,2179,4280
4041,"NYAMIRA","55-59",9204,9654,18858
4042,"NYAMIRA",60,2282,2508,4790
4043,"NYAMIRA",61,1774,1807,3581
4044,"NYAMIRA",62,1195,1138,2333
4045,"NYAMIRA",63,1286,1377,2663
4046,"NYAMIRA",64,842,934,1776
4047,"NYAMIRA","60-64",7379,7764,15143
4048,"NYAMIRA",65,1366,1674,3040
4049,"NYAMIRA",66,691,710,1401
4050,"NYAMIRA",67,1238,1228,2466
4051,"NYAMIRA",68,564,631,1195
4052,"NYAMIRA",69,978,1279,2257
4053,"NYAMIRA","65-69",4837,5522,10359
4054,"NYAMIRA",70,1214,1766,2980
4055,"NYAMIRA",71,948,956,1904
4056,"NYAMIRA",72,600,577,1177
4057,"NYAMIRA",73,536,471,1007
4058,"NYAMIRA",74,529,653,1182
4059,"NYAMIRA","70-74",3827,4423,8250
4060,"NYAMIRA",75,478,617,1095
4061,"NYAMIRA",76,283,285,568
4062,"NYAMIRA",77,441,452,893
4063,"NYAMIRA",78,266,248,514
4064,"NYAMIRA",79,375,653,1028
4065,"NYAMIRA","75-79",1843,2255,4098
4066,"NYAMIRA",80,398,762,1160
4067,"NYAMIRA",81,277,355,632
4068,"NYAMIRA",82,194,164,358
4069,"NYAMIRA",83,237,228,465
4070,"NYAMIRA",84,226,328,554
4071,"NYAMIRA","80-84",1332,1837,3169
4072,"NYAMIRA",85,189,299,488
4073,"NYAMIRA",86,124,140,264
4074,"NYAMIRA",87,175,198,373
4075,"NYAMIRA",88,109,67,176
4076,"NYAMIRA",89,152,377,529
4077,"NYAMIRA","85-89",749,1081,1830
4078,"NYAMIRA",90,98,224,322
4079,"NYAMIRA",91,67,88,155
4080,"NYAMIRA",92,47,51,98
4081,"NYAMIRA",93,34,43,77
4082,"NYAMIRA",94,42,58,100
4083,"NYAMIRA","90-94",288,464,752
4084,"NYAMIRA",95,66,86,152
4085,"NYAMIRA",96,13,29,42
4086,"NYAMIRA",97,28,22,50
4087,"NYAMIRA",98,24,26,50
4088,"NYAMIRA",99,29,72,101
4089,"NYAMIRA","95-99",160,235,395
4090,"NYAMIRA","100+",52,121,173
4091,"NYAMIRA","Not Stated",1,2,3
4093,"NYANDARUA","Total",282499,289240,571739
4094,"NYANDARUA",0,5907,5979,11886
4095,"NYANDARUA",1,6007,5873,11880
4096,"NYANDARUA",2,6225,6041,12266
4097,"NYANDARUA",3,6378,6271,12649
4098,"NYANDARUA",4,6562,6236,12798
4099,"NYANDARUA","0 - 4",31079,30400,61479
4100,"NYANDARUA",5,6560,6180,12740
4101,"NYANDARUA",6,6505,6555,13060
4102,"NYANDARUA",7,6984,6654,13638
4103,"NYANDARUA",8,6725,6669,13394
4104,"NYANDARUA",9,7643,7423,15066
4105,"NYANDARUA","5-9",34417,33481,67898
4106,"NYANDARUA",10,7564,7073,14637
4107,"NYANDARUA",11,7057,6954,14011
4108,"NYANDARUA",12,8043,7472,15515
4109,"NYANDARUA",13,8230,7822,16052
4110,"NYANDARUA",14,8363,7747,16110
4111,"NYANDARUA","10-14",39257,37068,76325
4112,"NYANDARUA",15,8091,7453,15544
4113,"NYANDARUA",16,7888,7528,15416
4114,"NYANDARUA",17,8083,7222,15305
4115,"NYANDARUA",18,6287,5520,11807
4116,"NYANDARUA",19,6177,5343,11520
4117,"NYANDARUA","15-19",36526,33066,69592
4118,"NYANDARUA",20,4937,4469,9406
4119,"NYANDARUA",21,4529,4199,8728
4120,"NYANDARUA",22,4231,3893,8124
4121,"NYANDARUA",23,3891,3996,7887
4122,"NYANDARUA",24,3362,3643,7005
4123,"NYANDARUA","20-24",20950,20200,41150
4124,"NYANDARUA",25,3720,3554,7274
4125,"NYANDARUA",26,2861,3154,6015
4126,"NYANDARUA",27,3030,3244,6274
4127,"NYANDARUA",28,2725,2969,5694
4128,"NYANDARUA",29,3028,3345,6373
4129,"NYANDARUA","25-29",15364,16266,31630
4130,"NYANDARUA",30,3668,4301,7969
4131,"NYANDARUA",31,2925,3193,6118
4132,"NYANDARUA",32,3588,4279,7867
4133,"NYANDARUA",33,3137,3828,6965
4134,"NYANDARUA",34,3160,3565,6725
4135,"NYANDARUA","30-34",16478,19166,35644
4136,"NYANDARUA",35,4346,4661,9007
4137,"NYANDARUA",36,3052,3499,6551
4138,"NYANDARUA",37,3193,3345,6538
4139,"NYANDARUA",38,2623,3067,5690
4140,"NYANDARUA",39,3059,3383,6442
4141,"NYANDARUA","35-39",16273,17955,34228
4142,"NYANDARUA",40,3553,3774,7327
4143,"NYANDARUA",41,3365,3582,6947
4144,"NYANDARUA",42,3163,3408,6571
4145,"NYANDARUA",43,2770,3079,5849
4146,"NYANDARUA",44,2302,2514,4816
4147,"NYANDARUA","40-44",15153,16357,31510
4148,"NYANDARUA",45,3489,3739,7228
4149,"NYANDARUA",46,2745,3043,5788
4150,"NYANDARUA",47,3044,3201,6245
4151,"NYANDARUA",48,2232,2505,4737
4152,"NYANDARUA",49,2564,2823,5387
4153,"NYANDARUA","45-49",14074,15311,29385
4154,"NYANDARUA",50,2812,3204,6016
4155,"NYANDARUA",51,2338,2490,4828
4156,"NYANDARUA",52,2595,2666,5261
4157,"NYANDARUA",53,1852,2093,3945
4158,"NYANDARUA",54,2133,2375,4508
4159,"NYANDARUA","50-54",11730,12828,24558
4160,"NYANDARUA",55,2354,2424,4778
4161,"NYANDARUA",56,2369,2357,4726
4162,"NYANDARUA",57,1814,2261,4075
4163,"NYANDARUA",58,1662,1749,3411
4164,"NYANDARUA",59,1718,1957,3675
4165,"NYANDARUA","55-59",9917,10748,20665
4166,"NYANDARUA",60,1898,2020,3918
4167,"NYANDARUA",61,1365,1545,2910
4168,"NYANDARUA",62,1349,1271,2620
4169,"NYANDARUA",63,1081,1082,2163
4170,"NYANDARUA",64,712,839,1551
4171,"NYANDARUA","60-64",6405,6757,13162
4172,"NYANDARUA",65,1288,1226,2514
4173,"NYANDARUA",66,872,919,1791
4174,"NYANDARUA",67,1433,1591,3024
4175,"NYANDARUA",68,583,768,1351
4176,"NYANDARUA",69,929,1164,2093
4177,"NYANDARUA","65-69",5105,5668,10773
4178,"NYANDARUA",70,1199,1528,2727
4179,"NYANDARUA",71,859,1048,1907
4180,"NYANDARUA",72,806,931,1737
4181,"NYANDARUA",73,642,770,1412
4182,"NYANDARUA",74,628,850,1478
4183,"NYANDARUA","70-74",4134,5127,9261
4184,"NYANDARUA",75,557,859,1416
4185,"NYANDARUA",76,719,1554,2273
4186,"NYANDARUA",77,455,643,1098
4187,"NYANDARUA",78,291,455,746
4188,"NYANDARUA",79,368,602,970
4189,"NYANDARUA","75-79",2390,4113,6503
4190,"NYANDARUA",80,507,736,1243
4191,"NYANDARUA",81,282,419,701
4192,"NYANDARUA",82,252,307,559
4193,"NYANDARUA",83,365,311,676
4194,"NYANDARUA",84,312,409,721
4195,"NYANDARUA","80-84",1718,2182,3900
4196,"NYANDARUA",85,241,341,582
4197,"NYANDARUA",86,163,282,445
4198,"NYANDARUA",87,176,243,419
4199,"NYANDARUA",88,105,129,234
4200,"NYANDARUA",89,185,345,530
4201,"NYANDARUA","85-89",870,1340,2210
4202,"NYANDARUA",90,127,216,343
4203,"NYANDARUA",91,138,174,312
4204,"NYANDARUA",92,54,102,156
4205,"NYANDARUA",93,48,70,118
4206,"NYANDARUA",94,29,101,130
4207,"NYANDARUA","90-94",396,663,1059
4208,"NYANDARUA",95,47,111,158
4209,"NYANDARUA",96,27,61,88
4210,"NYANDARUA",97,46,75,121
4211,"NYANDARUA",98,27,37,64
4212,"NYANDARUA",99,41,71,112
4213,"NYANDARUA","95-99",188,355,543
4214,"NYANDARUA","100+",71,189,260
4215,"NYANDARUA","Not Stated",4,"-",4
4217,"NYERI","Total",300893,307488,608381
4218,"NYERI",0,5496,5426,10922
4219,"NYERI",1,5507,5512,11019
4220,"NYERI",2,5662,5484,11146
4221,"NYERI",3,5947,5693,11640
4222,"NYERI",4,5971,5703,11674
4223,"NYERI","0 - 4",28583,27818,56401
4224,"NYERI",5,5945,5773,11718
4225,"NYERI",6,6059,5938,11997
4226,"NYERI",7,6290,6070,12360
4227,"NYERI",8,6148,6111,12259
4228,"NYERI",9,6543,6377,12920
4229,"NYERI","5-9",30985,30269,61254
4230,"NYERI",10,6510,6243,12753
4231,"NYERI",11,6037,5974,12011
4232,"NYERI",12,6722,6259,12981
4233,"NYERI",13,6873,6462,13335
4234,"NYERI",14,6720,6081,12801
4235,"NYERI","10-14",32862,31019,63881
4236,"NYERI",15,6649,6278,12927
4237,"NYERI",16,6581,6166,12747
4238,"NYERI",17,7107,6266,13373
4239,"NYERI",18,5873,5095,10968
4240,"NYERI",19,5768,4967,10735
4241,"NYERI","15-19",31978,28772,60750
4242,"NYERI",20,4971,4457,9428
4243,"NYERI",21,4631,4108,8739
4244,"NYERI",22,4325,4033,8358
4245,"NYERI",23,4376,4012,8388
4246,"NYERI",24,3715,3481,7196
4247,"NYERI","20-24",22018,20091,42109
4248,"NYERI",25,3764,3480,7244
4249,"NYERI",26,3120,3236,6356
4250,"NYERI",27,3210,3275,6485
4251,"NYERI",28,2929,3144,6073
4252,"NYERI",29,3320,3552,6872
4253,"NYERI","25-29",16343,16687,33030
4254,"NYERI",30,4154,4404,8558
4255,"NYERI",31,3311,3467,6778
4256,"NYERI",32,4130,4440,8570
4257,"NYERI",33,3671,4036,7707
4258,"NYERI",34,3562,3816,7378
4259,"NYERI","30-34",18828,20163,38991
4260,"NYERI",35,4845,5047,9892
4261,"NYERI",36,3735,3948,7683
4262,"NYERI",37,3920,3983,7903
4263,"NYERI",38,3468,3745,7213
4264,"NYERI",39,3685,4210,7895
4265,"NYERI","35-39",19653,20933,40586
4266,"NYERI",40,4618,4599,9217
4267,"NYERI",41,3842,3921,7763
4268,"NYERI",42,3943,3792,7735
4269,"NYERI",43,3425,3868,7293
4270,"NYERI",44,3190,3379,6569
4271,"NYERI","40-44",19018,19559,38577
4272,"NYERI",45,4354,4360,8714
4273,"NYERI",46,3514,3599,7113
4274,"NYERI",47,3687,3768,7455
4275,"NYERI",48,3170,3066,6236
4276,"NYERI",49,3321,3484,6805
4277,"NYERI","45-49",18046,18277,36323
4278,"NYERI",50,3835,4129,7964
4279,"NYERI",51,3010,3192,6202
4280,"NYERI",52,3333,3637,6970
4281,"NYERI",53,2461,2962,5423
4282,"NYERI",54,3082,3160,6242
4283,"NYERI","50-54",15721,17080,32801
4284,"NYERI",55,3101,3251,6352
4285,"NYERI",56,3079,3108,6187
4286,"NYERI",57,2706,3015,5721
4287,"NYERI",58,2366,2507,4873
4288,"NYERI",59,2456,2668,5124
4289,"NYERI","55-59",13708,14549,28257
4290,"NYERI",60,2723,3078,5801
4291,"NYERI",61,2097,2301,4398
4292,"NYERI",62,1824,1878,3702
4293,"NYERI",63,1438,1601,3039
4294,"NYERI",64,1041,1189,2230
4295,"NYERI","60-64",9123,10047,19170
4296,"NYERI",65,1724,2019,3743
4297,"NYERI",66,1242,1343,2585
4298,"NYERI",67,2263,2448,4711
4299,"NYERI",68,1083,1145,2228
4300,"NYERI",69,1586,1740,3326
4301,"NYERI","65-69",7898,8695,16593
4302,"NYERI",70,2097,2835,4932
4303,"NYERI",71,1524,1759,3283
4304,"NYERI",72,1505,1421,2926
4305,"NYERI",73,1223,1261,2484
4306,"NYERI",74,1039,1360,2399
4307,"NYERI","70-74",7388,8636,16024
4308,"NYERI",75,905,1266,2171
4309,"NYERI",76,992,1904,2896
4310,"NYERI",77,745,1152,1897
4311,"NYERI",78,532,700,1232
4312,"NYERI",79,560,1042,1602
4313,"NYERI","75-79",3734,6064,9798
4314,"NYERI",80,862,1431,2293
4315,"NYERI",81,482,712,1194
4316,"NYERI",82,460,533,993
4317,"NYERI",83,516,697,1213
4318,"NYERI",84,390,640,1030
4319,"NYERI","80-84",2710,4013,6723
4320,"NYERI",85,342,572,914
4321,"NYERI",86,300,514,814
4322,"NYERI",87,280,430,710
4323,"NYERI",88,142,254,396
4324,"NYERI",89,241,591,832
4325,"NYERI","85-89",1305,2361,3666
4326,"NYERI",90,174,476,650
4327,"NYERI",91,197,376,573
4328,"NYERI",92,85,171,256
4329,"NYERI",93,81,165,246
4330,"NYERI",94,69,171,240
4331,"NYERI","90-94",606,1359,1965
4332,"NYERI",95,95,226,321
4333,"NYERI",96,53,123,176
4334,"NYERI",97,62,105,167
4335,"NYERI",98,47,96,143
4336,"NYERI",99,42,167,209
4337,"NYERI","95-99",299,717,1016
4338,"NYERI","100+",83,377,460
4339,"NYERI","Not Stated",4,2,6
4341,"SAMBURU","Total",133058,130130,263188
4342,"SAMBURU",0,3865,3741,7606
4343,"SAMBURU",1,3648,3651,7299
4344,"SAMBURU",2,4645,4795,9440
4345,"SAMBURU",3,4954,4895,9849
4346,"SAMBURU",4,5123,4967,10090
4347,"SAMBURU","0 - 4",22235,22049,44284
4348,"SAMBURU",5,5318,5233,10551
4349,"SAMBURU",6,5140,5032,10172
4350,"SAMBURU",7,4335,4173,8508
4351,"SAMBURU",8,5142,5065,10207
4352,"SAMBURU",9,3710,3624,7334
4353,"SAMBURU","5-9",23645,23127,46772
4354,"SAMBURU",10,6565,6255,12820
4355,"SAMBURU",11,2785,3102,5887
4356,"SAMBURU",12,5171,4380,9551
4357,"SAMBURU",13,3636,3207,6843
4358,"SAMBURU",14,3927,3242,7169
4359,"SAMBURU","10-14",22084,20186,42270
4360,"SAMBURU",15,4620,3730,8350
4361,"SAMBURU",16,3329,2616,5945
4362,"SAMBURU",17,3253,2239,5492
4363,"SAMBURU",18,3466,2759,6225
4364,"SAMBURU",19,2586,2127,4713
4365,"SAMBURU","15-19",17254,13471,30725
4366,"SAMBURU",20,3975,3633,7608
4367,"SAMBURU",21,1924,2082,4006
4368,"SAMBURU",22,2076,2147,4223
4369,"SAMBURU",23,2041,2334,4375
4370,"SAMBURU",24,1754,1749,3503
4371,"SAMBURU","20-24",11770,11945,23715
4372,"SAMBURU",25,2762,2823,5585
4373,"SAMBURU",26,1443,1787,3230
4374,"SAMBURU",27,1369,1696,3065
4375,"SAMBURU",28,1435,1460,2895
4376,"SAMBURU",29,1550,1588,3138
4377,"SAMBURU","25-29",8559,9354,17913
4378,"SAMBURU",30,2808,2703,5511
4379,"SAMBURU",31,947,1255,2202
4380,"SAMBURU",32,1225,1577,2802
4381,"SAMBURU",33,880,1263,2143
4382,"SAMBURU",34,661,792,1453
4383,"SAMBURU","30-34",6521,7590,14111
4384,"SAMBURU",35,1800,1996,3796
4385,"SAMBURU",36,628,854,1482
4386,"SAMBURU",37,549,487,1036
4387,"SAMBURU",38,485,440,925
4388,"SAMBURU",39,549,520,1069
4389,"SAMBURU","35-39",4011,4297,8308
4390,"SAMBURU",40,1658,1279,2937
4391,"SAMBURU",41,850,802,1652
4392,"SAMBURU",42,779,757,1536
4393,"SAMBURU",43,584,610,1194
4394,"SAMBURU",44,344,324,668
4395,"SAMBURU","40-44",4215,3772,7987
4396,"SAMBURU",45,1189,1111,2300
4397,"SAMBURU",46,598,778,1376
4398,"SAMBURU",47,625,692,1317
4399,"SAMBURU",48,397,484,881
4400,"SAMBURU",49,475,500,975
4401,"SAMBURU","45-49",3284,3565,6849
4402,"SAMBURU",50,977,1040,2017
4403,"SAMBURU",51,281,407,688
4404,"SAMBURU",52,297,366,663
4405,"SAMBURU",53,203,232,435
4406,"SAMBURU",54,334,341,675
4407,"SAMBURU","50-54",2092,2386,4478
4408,"SAMBURU",55,461,425,886
4409,"SAMBURU",56,345,305,650
4410,"SAMBURU",57,237,284,521
4411,"SAMBURU",58,270,236,506
4412,"SAMBURU",59,418,536,954
4413,"SAMBURU","55-59",1731,1786,3517
4414,"SAMBURU",60,898,893,1791
4415,"SAMBURU",61,312,339,651
4416,"SAMBURU",62,266,319,585
4417,"SAMBURU",63,270,349,619
4418,"SAMBURU",64,167,244,411
4419,"SAMBURU","60-64",1913,2144,4057
4420,"SAMBURU",65,393,463,856
4421,"SAMBURU",66,118,128,246
4422,"SAMBURU",67,176,248,424
4423,"SAMBURU",68,167,177,344
4424,"SAMBURU",69,222,348,570
4425,"SAMBURU","65-69",1076,1364,2440
4426,"SAMBURU",70,581,656,1237
4427,"SAMBURU",71,239,313,552
4428,"SAMBURU",72,139,136,275
4429,"SAMBURU",73,127,139,266
4430,"SAMBURU",74,126,139,265
4431,"SAMBURU","70-74",1212,1383,2595
4432,"SAMBURU",75,244,207,451
4433,"SAMBURU",76,62,78,140
4434,"SAMBURU",77,77,76,153
4435,"SAMBURU",78,60,77,137
4436,"SAMBURU",79,166,219,385
4437,"SAMBURU","75-79",609,657,1266
4438,"SAMBURU",80,225,305,530
4439,"SAMBURU",81,87,89,176
4440,"SAMBURU",82,47,57,104
4441,"SAMBURU",83,48,75,123
4442,"SAMBURU",84,51,59,110
4443,"SAMBURU","80-84",458,585,1043
4444,"SAMBURU",85,43,68,111
4445,"SAMBURU",86,22,28,50
4446,"SAMBURU",87,31,41,72
4447,"SAMBURU",88,23,23,46
4448,"SAMBURU",89,87,104,191
4449,"SAMBURU","85-89",206,264,470
4450,"SAMBURU",90,54,79,133
4451,"SAMBURU",91,15,18,33
4452,"SAMBURU",92,8,4,12
4453,"SAMBURU",93,13,13,26
4454,"SAMBURU",94,10,9,19
4455,"SAMBURU","90-94",100,123,223
4456,"SAMBURU",95,24,26,50
4457,"SAMBURU",96,10,7,17
4458,"SAMBURU",97,4,5,9
4459,"SAMBURU",98,7,5,12
4460,"SAMBURU",99,12,18,30
4461,"SAMBURU","95-99",57,61,118
4462,"SAMBURU","100+",25,20,45
4463,"SAMBURU","Not Stated",1,1,2
4465,"SIAYA","Total",431450,476301,907751
4466,"SIAYA",0,10481,10607,21088
4467,"SIAYA",1,10563,10473,21036
4468,"SIAYA",2,10640,10812,21452
4469,"SIAYA",3,11745,11713,23458
4470,"SIAYA",4,11955,11671,23626
4471,"SIAYA","0 - 4",55384,55276,110660
4472,"SIAYA",5,12508,11960,24468
4473,"SIAYA",6,13084,12990,26074
4474,"SIAYA",7,12600,12823,25423
4475,"SIAYA",8,11947,12444,24391
4476,"SIAYA",9,13636,13542,27178
4477,"SIAYA","5-9",63775,63759,127534
4478,"SIAYA",10,14576,14040,28616
4479,"SIAYA",11,13314,13442,26756
4480,"SIAYA",12,15155,14702,29857
4481,"SIAYA",13,14690,14450,29140
4482,"SIAYA",14,13227,12834,26061
4483,"SIAYA","10-14",70962,69468,140430
4484,"SIAYA",15,13082,12436,25518
4485,"SIAYA",16,11581,11336,22917
4486,"SIAYA",17,11784,10933,22717
4487,"SIAYA",18,9157,8784,17941
4488,"SIAYA",19,9456,9325,18781
4489,"SIAYA","15-19",55060,52814,107874
4490,"SIAYA",20,8080,8603,16683
4491,"SIAYA",21,6762,7412,14174
4492,"SIAYA",22,6052,7227,13279
4493,"SIAYA",23,5915,7479,13394
4494,"SIAYA",24,5357,6758,12115
4495,"SIAYA","20-24",32166,37479,69645
4496,"SIAYA",25,5955,7417,13372
4497,"SIAYA",26,4984,6741,11725
4498,"SIAYA",27,5452,6774,12226
4499,"SIAYA",28,4061,5006,9067
4500,"SIAYA",29,4231,5521,9752
4501,"SIAYA","25-29",24683,31459,56142
4502,"SIAYA",30,6065,8101,14166
4503,"SIAYA",31,4344,5143,9487
4504,"SIAYA",32,5458,7058,12516
4505,"SIAYA",33,4895,6168,11063
4506,"SIAYA",34,4765,5514,10279
4507,"SIAYA","30-34",25527,31984,57511
4508,"SIAYA",35,5695,6101,11796
4509,"SIAYA",36,4213,4250,8463
4510,"SIAYA",37,4600,4264,8864
4511,"SIAYA",38,3064,2834,5898
4512,"SIAYA",39,3776,3704,7480
4513,"SIAYA","35-39",21348,21153,42501
4514,"SIAYA",40,4459,4888,9347
4515,"SIAYA",41,3864,3919,7783
4516,"SIAYA",42,3700,3643,7343
4517,"SIAYA",43,3418,3638,7056
4518,"SIAYA",44,2834,3163,5997
4519,"SIAYA","40-44",18275,19251,37526
4520,"SIAYA",45,3658,4152,7810
4521,"SIAYA",46,2665,3146,5811
4522,"SIAYA",47,2863,3235,6098
4523,"SIAYA",48,1779,2152,3931
4524,"SIAYA",49,2067,2528,4595
4525,"SIAYA","45-49",13032,15213,28245
4526,"SIAYA",50,2784,4115,6899
4527,"SIAYA",51,2360,3354,5714
4528,"SIAYA",52,1888,2531,4419
4529,"SIAYA",53,1589,2196,3785
4530,"SIAYA",54,1890,2392,4282
4531,"SIAYA","50-54",10511,14588,25099
4532,"SIAYA",55,2155,2746,4901
4533,"SIAYA",56,2055,3114,5169
4534,"SIAYA",57,2102,3762,5864
4535,"SIAYA",58,1459,2107,3566
4536,"SIAYA",59,1800,2748,4548
4537,"SIAYA","55-59",9571,14477,24048
4538,"SIAYA",60,2466,4026,6492
4539,"SIAYA",61,1821,2790,4611
4540,"SIAYA",62,1701,2372,4073
4541,"SIAYA",63,1628,2507,4135
4542,"SIAYA",64,1398,2083,3481
4543,"SIAYA","60-64",9014,13778,22792
4544,"SIAYA",65,1900,2839,4739
4545,"SIAYA",66,1512,2394,3906
4546,"SIAYA",67,2064,3348,5412
4547,"SIAYA",68,897,1242,2139
4548,"SIAYA",69,1454,2024,3478
4549,"SIAYA","65-69",7827,11847,19674
4550,"SIAYA",70,1944,3479,5423
4551,"SIAYA",71,1368,1908,3276
4552,"SIAYA",72,1230,1482,2712
4553,"SIAYA",73,972,1329,2301
4554,"SIAYA",74,936,1421,2357
4555,"SIAYA","70-74",6450,9619,16069
4556,"SIAYA",75,734,1297,2031
4557,"SIAYA",76,681,1084,1765
4558,"SIAYA",77,868,1582,2450
4559,"SIAYA",78,417,664,1081
4560,"SIAYA",79,580,1287,1867
4561,"SIAYA","75-79",3280,5914,9194
4562,"SIAYA",80,736,1482,2218
4563,"SIAYA",81,465,892,1357
4564,"SIAYA",82,488,704,1192
4565,"SIAYA",83,460,689,1149
4566,"SIAYA",84,386,623,1009
4567,"SIAYA","80-84",2535,4390,6925
4568,"SIAYA",85,321,649,970
4569,"SIAYA",86,258,401,659
4570,"SIAYA",87,377,612,989
4571,"SIAYA",88,158,291,449
4572,"SIAYA",89,253,634,887
4573,"SIAYA","85-89",1367,2587,3954
4574,"SIAYA",90,158,310,468
4575,"SIAYA",91,125,212,337
4576,"SIAYA",92,77,111,188
4577,"SIAYA",93,58,99,157
4578,"SIAYA",94,56,91,147
4579,"SIAYA","90-94",474,823,1297
4580,"SIAYA",95,62,95,157
4581,"SIAYA",96,27,50,77
4582,"SIAYA",97,27,53,80
4583,"SIAYA",98,15,44,59
4584,"SIAYA",99,25,60,85
4585,"SIAYA","95-99",156,302,458
4586,"SIAYA","100+",43,113,156
4587,"SIAYA","Not Stated",10,7,17
4589,"TAITA-TAVETA","Total",126717,120178,246895
4590,"TAITA-TAVETA",0,2606,2644,5250
4591,"TAITA-TAVETA",1,2672,2777,5449
4592,"TAITA-TAVETA",2,2678,2604,5282
4593,"TAITA-TAVETA",3,2815,2717,5532
4594,"TAITA-TAVETA",4,2737,2704,5441
4595,"TAITA-TAVETA","0 - 4",13508,13446,26954
4596,"TAITA-TAVETA",5,2776,2676,5452
4597,"TAITA-TAVETA",6,2671,2631,5302
4598,"TAITA-TAVETA",7,2730,2711,5441
4599,"TAITA-TAVETA",8,2778,2703,5481
4600,"TAITA-TAVETA",9,2904,2979,5883
4601,"TAITA-TAVETA","9-14",13859,13700,27559
4602,"TAITA-TAVETA",10,2975,2950,5925
4603,"TAITA-TAVETA",11,3082,2992,6074
4604,"TAITA-TAVETA",12,3239,3025,6264
4605,"TAITA-TAVETA",13,3145,3137,6282
4606,"TAITA-TAVETA",14,3055,2832,5887
4607,"TAITA-TAVETA","10-14",15496,14936,30432
4608,"TAITA-TAVETA",15,2837,2812,5649
4609,"TAITA-TAVETA",16,2797,2659,5456
4610,"TAITA-TAVETA",17,3006,2629,5635
4611,"TAITA-TAVETA",18,2593,2179,4772
4612,"TAITA-TAVETA",19,2429,2158,4587
4613,"TAITA-TAVETA","15-19",13662,12437,26099
4614,"TAITA-TAVETA",20,2406,2114,4520
4615,"TAITA-TAVETA",21,1984,1667,3651
4616,"TAITA-TAVETA",22,2017,1758,3775
4617,"TAITA-TAVETA",23,2022,1787,3809
4618,"TAITA-TAVETA",24,1756,1642,3398
4619,"TAITA-TAVETA","20-24",10185,8968,19153
4620,"TAITA-TAVETA",25,1938,1687,3625
4621,"TAITA-TAVETA",26,1612,1508,3120
4622,"TAITA-TAVETA",27,1731,1570,3301
4623,"TAITA-TAVETA",28,1513,1433,2946
4624,"TAITA-TAVETA",29,1788,1603,3391
4625,"TAITA-TAVETA","25-29",8582,7801,16383
4626,"TAITA-TAVETA",30,2042,1772,3814
4627,"TAITA-TAVETA",31,1536,1434,2970
4628,"TAITA-TAVETA",32,1937,1649,3586
4629,"TAITA-TAVETA",33,1588,1491,3079
4630,"TAITA-TAVETA",34,1534,1289,2823
4631,"TAITA-TAVETA","30-34",8637,7635,16272
4632,"TAITA-TAVETA",35,1999,1648,3647
4633,"TAITA-TAVETA",36,1636,1383,3019
4634,"TAITA-TAVETA",37,1628,1411,3039
4635,"TAITA-TAVETA",38,1322,1102,2424
4636,"TAITA-TAVETA",39,1543,1354,2897
4637,"TAITA-TAVETA","35-39",8128,6898,15026
4638,"TAITA-TAVETA",40,1761,1444,3205
4639,"TAITA-TAVETA",41,1526,1270,2796
4640,"TAITA-TAVETA",42,1492,1197,2689
4641,"TAITA-TAVETA",43,1312,1093,2405
4642,"TAITA-TAVETA",44,1234,1049,2283
4643,"TAITA-TAVETA","40-44",7325,6053,13378
4644,"TAITA-TAVETA",45,1655,1384,3039
4645,"TAITA-TAVETA",46,1262,1142,2404
4646,"TAITA-TAVETA",47,1343,1232,2575
4647,"TAITA-TAVETA",48,1023,924,1947
4648,"TAITA-TAVETA",49,1168,1075,2243
4649,"TAITA-TAVETA","45-49",6451,5757,12208
4650,"TAITA-TAVETA",50,1397,1167,2564
4651,"TAITA-TAVETA",51,1059,881,1940
4652,"TAITA-TAVETA",52,933,822,1755
4653,"TAITA-TAVETA",53,811,738,1549
4654,"TAITA-TAVETA",54,969,893,1862
4655,"TAITA-TAVETA","50-54",5169,4501,9670
4656,"TAITA-TAVETA",55,938,882,1820
4657,"TAITA-TAVETA",56,1017,919,1936
4658,"TAITA-TAVETA",57,885,1193,2078
4659,"TAITA-TAVETA",58,646,791,1437
4660,"TAITA-TAVETA",59,784,876,1660
4661,"TAITA-TAVETA","55-59",4270,4661,8931
4662,"TAITA-TAVETA",60,919,1106,2025
4663,"TAITA-TAVETA",61,755,800,1555
4664,"TAITA-TAVETA",62,741,734,1475
4665,"TAITA-TAVETA",63,694,703,1397
4666,"TAITA-TAVETA",64,578,548,1126
4667,"TAITA-TAVETA","60-64",3687,3891,7578
4668,"TAITA-TAVETA",65,745,872,1617
4669,"TAITA-TAVETA",66,613,577,1190
4670,"TAITA-TAVETA",67,742,676,1418
4671,"TAITA-TAVETA",68,443,350,793
4672,"TAITA-TAVETA",69,538,624,1162
4673,"TAITA-TAVETA","65-69",3081,3099,6180
4674,"TAITA-TAVETA",70,593,948,1541
4675,"TAITA-TAVETA",71,442,473,915
4676,"TAITA-TAVETA",72,401,341,742
4677,"TAITA-TAVETA",73,330,318,648
4678,"TAITA-TAVETA",74,319,436,755
4679,"TAITA-TAVETA","70-74",2085,2516,4601
4680,"TAITA-TAVETA",75,286,341,627
4681,"TAITA-TAVETA",76,207,246,453
4682,"TAITA-TAVETA",77,287,298,585
4683,"TAITA-TAVETA",78,168,171,339
4684,"TAITA-TAVETA",79,227,363,590
4685,"TAITA-TAVETA","75-79",1175,1419,2594
4686,"TAITA-TAVETA",80,256,393,649
4687,"TAITA-TAVETA",81,160,237,397
4688,"TAITA-TAVETA",82,115,151,266
4689,"TAITA-TAVETA",83,143,193,336
4690,"TAITA-TAVETA",84,105,196,301
4691,"TAITA-TAVETA","80-84",779,1170,1949
4692,"TAITA-TAVETA",85,101,169,270
4693,"TAITA-TAVETA",86,70,91,161
4694,"TAITA-TAVETA",87,74,168,242
4695,"TAITA-TAVETA",88,53,75,128
4696,"TAITA-TAVETA",89,79,243,322
4697,"TAITA-TAVETA","85-89",377,746,1123
4698,"TAITA-TAVETA",90,51,121,172
4699,"TAITA-TAVETA",91,34,72,106
4700,"TAITA-TAVETA",92,27,30,57
4701,"TAITA-TAVETA",93,25,38,63
4702,"TAITA-TAVETA",94,16,42,58
4703,"TAITA-TAVETA","90-94",153,303,456
4704,"TAITA-TAVETA",95,21,41,62
4705,"TAITA-TAVETA",96,7,23,30
4706,"TAITA-TAVETA",97,16,23,39
4707,"TAITA-TAVETA",98,7,23,30
4708,"TAITA-TAVETA",99,19,55,74
4709,"TAITA-TAVETA","95-99",70,165,235
4710,"TAITA-TAVETA","100+",37,75,112
4711,"TAITA-TAVETA","Not Stated",1,1,2
4713,"TANARIVER","Total",120696,119524,240220
4714,"TANARIVER",0,3835,3747,7582
4715,"TANARIVER",1,3797,3468,7265
4716,"TANARIVER",2,4471,4227,8698
4717,"TANARIVER",3,4500,4401,8901
4718,"TANARIVER",4,4885,4578,9463
4719,"TANARIVER","0 - 4",21488,20421,41909
4720,"TANARIVER",5,4624,4443,9067
4721,"TANARIVER",6,4676,4506,9182
4722,"TANARIVER",7,4386,3989,8375
4723,"TANARIVER",8,4506,4294,8800
4724,"TANARIVER",9,3568,3460,7028
4725,"TANARIVER","5-9",21760,20692,42452
4726,"TANARIVER",10,4842,4702,9544
4727,"TANARIVER",11,3110,2985,6095
4728,"TANARIVER",12,4339,3910,8249
4729,"TANARIVER",13,3458,3334,6792
4730,"TANARIVER",14,3301,3119,6420
4731,"TANARIVER","10-14",19050,18050,37100
4732,"TANARIVER",15,3453,3181,6634
4733,"TANARIVER",16,2615,2456,5071
4734,"TANARIVER",17,2598,2183,4781
4735,"TANARIVER",18,2648,2423,5071
4736,"TANARIVER",19,1907,1959,3866
4737,"TANARIVER","15-19",13221,12202,25423
4738,"TANARIVER",20,2529,2767,5296
4739,"TANARIVER",21,1450,1680,3130
4740,"TANARIVER",22,1797,1950,3747
4741,"TANARIVER",23,1611,1680,3291
4742,"TANARIVER",24,1398,1643,3041
4743,"TANARIVER","20-24",8785,9720,18505
4744,"TANARIVER",25,2168,2561,4729
4745,"TANARIVER",26,1341,1431,2772
4746,"TANARIVER",27,1235,1565,2800
4747,"TANARIVER",28,1170,1551,2721
4748,"TANARIVER",29,1030,1113,2143
4749,"TANARIVER","25-29",6944,8221,15165
4750,"TANARIVER",30,2108,2602,4710
4751,"TANARIVER",31,875,1121,1996
4752,"TANARIVER",32,1133,1309,2442
4753,"TANARIVER",33,765,971,1736
4754,"TANARIVER",34,791,763,1554
4755,"TANARIVER","30-34",5672,6766,12438
4756,"TANARIVER",35,1812,1882,3694
4757,"TANARIVER",36,875,910,1785
4758,"TANARIVER",37,850,846,1696
4759,"TANARIVER",38,653,652,1305
4760,"TANARIVER",39,587,486,1073
4761,"TANARIVER","35-39",4777,4776,9553
4762,"TANARIVER",40,1675,1642,3317
4763,"TANARIVER",41,851,952,1803
4764,"TANARIVER",42,723,648,1371
4765,"TANARIVER",43,487,466,953
4766,"TANARIVER",44,415,328,743
4767,"TANARIVER","40-44",4151,4036,8187
4768,"TANARIVER",45,1315,1416,2731
4769,"TANARIVER",46,709,795,1504
4770,"TANARIVER",47,628,594,1222
4771,"TANARIVER",48,505,458,963
4772,"TANARIVER",49,473,386,859
4773,"TANARIVER","45-49",3630,3649,7279
4774,"TANARIVER",50,1117,1098,2215
4775,"TANARIVER",51,391,417,808
4776,"TANARIVER",52,478,437,915
4777,"TANARIVER",53,347,282,629
4778,"TANARIVER",54,431,418,849
4779,"TANARIVER","50-54",2764,2652,5416
4780,"TANARIVER",55,531,440,971
4781,"TANARIVER",56,528,413,941
4782,"TANARIVER",57,443,451,894
4783,"TANARIVER",58,426,483,909
4784,"TANARIVER",59,447,462,909
4785,"TANARIVER","55-59",2375,2249,4624
4786,"TANARIVER",60,850,933,1783
4787,"TANARIVER",61,403,342,745
4788,"TANARIVER",62,361,336,697
4789,"TANARIVER",63,370,341,711
4790,"TANARIVER",64,247,218,465
4791,"TANARIVER","60-64",2231,2170,4401
4792,"TANARIVER",65,454,498,952
4793,"TANARIVER",66,214,228,442
4794,"TANARIVER",67,274,236,510
4795,"TANARIVER",68,217,173,390
4796,"TANARIVER",69,252,289,541
4797,"TANARIVER","65-69",1411,1424,2835
4798,"TANARIVER",70,496,637,1133
4799,"TANARIVER",71,190,206,396
4800,"TANARIVER",72,149,125,274
4801,"TANARIVER",73,159,117,276
4802,"TANARIVER",74,113,96,209
4803,"TANARIVER","70-74",1107,1181,2288
4804,"TANARIVER",75,169,177,346
4805,"TANARIVER",76,112,109,221
4806,"TANARIVER",77,91,69,160
4807,"TANARIVER",78,98,70,168
4808,"TANARIVER",79,121,88,209
4809,"TANARIVER","75-79",591,513,1104
4810,"TANARIVER",80,200,233,433
4811,"TANARIVER",81,46,55,101
4812,"TANARIVER",82,57,33,90
4813,"TANARIVER",83,46,50,96
4814,"TANARIVER",84,43,32,75
4815,"TANARIVER","80-84",392,403,795
4816,"TANARIVER",85,72,51,123
4817,"TANARIVER",86,30,24,54
4818,"TANARIVER",87,43,35,78
4819,"TANARIVER",88,32,10,42
4820,"TANARIVER",89,37,54,91
4821,"TANARIVER","85-89",214,174,388
4822,"TANARIVER",90,44,84,128
4823,"TANARIVER",91,10,24,34
4824,"TANARIVER",92,7,12,19
4825,"TANARIVER",93,5,11,16
4826,"TANARIVER",94,5,2,7
4827,"TANARIVER","90-94",71,133,204
4828,"TANARIVER",95,11,18,29
4829,"TANARIVER",96,5,7,12
4830,"TANARIVER",97,3,8,11
4831,"TANARIVER",98,4,9,13
4832,"TANARIVER",99,9,9,18
4833,"TANARIVER","95-99",32,51,83
4834,"TANARIVER","100+",25,40,65
4835,"TANARIVER","Not Stated",5,1,6
4837,"THARAKA-NITHI","Total",177716,182712,360428
4838,"THARAKA-NITHI",0,3469,3486,6955
4839,"THARAKA-NITHI",1,3564,3604,7168
4840,"THARAKA-NITHI",2,3743,3679,7422
4841,"THARAKA-NITHI",3,3800,3926,7726
4842,"THARAKA-NITHI",4,3786,3787,7573
4843,"THARAKA-NITHI","0 - 4",18362,18482,36844
4844,"THARAKA-NITHI",5,3996,3868,7864
4845,"THARAKA-NITHI",6,3897,3912,7809
4846,"THARAKA-NITHI",7,4089,3982,8071
4847,"THARAKA-NITHI",8,4038,4068,8106
4848,"THARAKA-NITHI",9,4318,4259,8577
4849,"THARAKA-NITHI","5-9",20338,20089,40427
4850,"THARAKA-NITHI",10,4520,4354,8874
4851,"THARAKA-NITHI",11,4213,4307,8520
4852,"THARAKA-NITHI",12,4793,4662,9455
4853,"THARAKA-NITHI",13,4778,4719,9497
4854,"THARAKA-NITHI",14,4602,4503,9105
4855,"THARAKA-NITHI","10-14",22906,22545,45451
4856,"THARAKA-NITHI",15,4431,4455,8886
4857,"THARAKA-NITHI",16,4246,4329,8575
4858,"THARAKA-NITHI",17,4420,4037,8457
4859,"THARAKA-NITHI",18,3594,3402,6996
4860,"THARAKA-NITHI",19,3675,3527,7202
4861,"THARAKA-NITHI","15-19",20366,19750,40116
4862,"THARAKA-NITHI",20,3117,3243,6360
4863,"THARAKA-NITHI",21,2723,2753,5476
4864,"THARAKA-NITHI",22,2641,2738,5379
4865,"THARAKA-NITHI",23,2675,2901,5576
4866,"THARAKA-NITHI",24,2394,2540,4934
4867,"THARAKA-NITHI","20-24",13550,14175,27725
4868,"THARAKA-NITHI",25,2606,2633,5239
4869,"THARAKA-NITHI",26,2111,2273,4384
4870,"THARAKA-NITHI",27,2340,2477,4817
4871,"THARAKA-NITHI",28,1939,2115,4054
4872,"THARAKA-NITHI",29,2230,2407,4637
4873,"THARAKA-NITHI","25-29",11226,11905,23131
4874,"THARAKA-NITHI",30,2742,3121,5863
4875,"THARAKA-NITHI",31,2149,2169,4318
4876,"THARAKA-NITHI",32,2498,2810,5308
4877,"THARAKA-NITHI",33,2379,2658,5037
4878,"THARAKA-NITHI",34,1945,2188,4133
4879,"THARAKA-NITHI","30-34",11713,12946,24659
4880,"THARAKA-NITHI",35,2896,3004,5900
4881,"THARAKA-NITHI",36,1978,2018,3996
4882,"THARAKA-NITHI",37,2150,2047,4197
4883,"THARAKA-NITHI",38,1721,1722,3443
4884,"THARAKA-NITHI",39,2189,2193,4382
4885,"THARAKA-NITHI","35-39",10934,10984,21918
4886,"THARAKA-NITHI",40,2423,2373,4796
4887,"THARAKA-NITHI",41,2123,1950,4073
4888,"THARAKA-NITHI",42,1925,1836,3761
4889,"THARAKA-NITHI",43,1708,1751,3459
4890,"THARAKA-NITHI",44,1579,1610,3189
4891,"THARAKA-NITHI","40-44",9758,9520,19278
4892,"THARAKA-NITHI",45,2241,2377,4618
4893,"THARAKA-NITHI",46,1957,1999,3956
4894,"THARAKA-NITHI",47,1792,1793,3585
4895,"THARAKA-NITHI",48,1410,1389,2799
4896,"THARAKA-NITHI",49,1714,1769,3483
4897,"THARAKA-NITHI","45-49",9114,9327,18441
4898,"THARAKA-NITHI",50,1789,1928,3717
4899,"THARAKA-NITHI",51,1446,1350,2796
4900,"THARAKA-NITHI",52,1106,969,2075
4901,"THARAKA-NITHI",53,873,846,1719
4902,"THARAKA-NITHI",54,1174,1054,2228
4903,"THARAKA-NITHI","50-54",6388,6147,12535
4904,"THARAKA-NITHI",55,1347,1212,2559
4905,"THARAKA-NITHI",56,1466,1422,2888
4906,"THARAKA-NITHI",57,1114,1356,2470
4907,"THARAKA-NITHI",58,1095,1167,2262
4908,"THARAKA-NITHI",59,1299,1400,2699
4909,"THARAKA-NITHI","55-59",6321,6557,12878
4910,"THARAKA-NITHI",60,1562,1594,3156
4911,"THARAKA-NITHI",61,1119,1141,2260
4912,"THARAKA-NITHI",62,972,911,1883
4913,"THARAKA-NITHI",63,873,944,1817
4914,"THARAKA-NITHI",64,639,637,1276
4915,"THARAKA-NITHI","60-64",5165,5227,10392
4916,"THARAKA-NITHI",65,956,1103,2059
4917,"THARAKA-NITHI",66,662,678,1340
4918,"THARAKA-NITHI",67,1127,1183,2310
4919,"THARAKA-NITHI",68,544,583,1127
4920,"THARAKA-NITHI",69,817,1060,1877
4921,"THARAKA-NITHI","65-69",4106,4607,8713
4922,"THARAKA-NITHI",70,1053,1470,2523
4923,"THARAKA-NITHI",71,772,868,1640
4924,"THARAKA-NITHI",72,552,635,1187
4925,"THARAKA-NITHI",73,397,523,920
4926,"THARAKA-NITHI",74,440,618,1058
4927,"THARAKA-NITHI","70-74",3214,4114,7328
4928,"THARAKA-NITHI",75,409,493,902
4929,"THARAKA-NITHI",76,277,336,613
4930,"THARAKA-NITHI",77,411,514,925
4931,"THARAKA-NITHI",78,266,265,531
4932,"THARAKA-NITHI",79,329,589,918
4933,"THARAKA-NITHI","75-79",1692,2197,3889
4934,"THARAKA-NITHI",80,453,684,1137
4935,"THARAKA-NITHI",81,192,356,548
4936,"THARAKA-NITHI",82,173,183,356
4937,"THARAKA-NITHI",83,227,277,504
4938,"THARAKA-NITHI",84,176,291,467
4939,"THARAKA-NITHI","80-84",1221,1791,3012
4940,"THARAKA-NITHI",85,169,247,416
4941,"THARAKA-NITHI",86,117,145,262
4942,"THARAKA-NITHI",87,165,238,403
4943,"THARAKA-NITHI",88,93,113,206
4944,"THARAKA-NITHI",89,201,424,625
4945,"THARAKA-NITHI","85-89",745,1167,1912
4946,"THARAKA-NITHI",90,95,192,287
4947,"THARAKA-NITHI",91,80,151,231
4948,"THARAKA-NITHI",92,35,62,97
4949,"THARAKA-NITHI",93,37,65,102
4950,"THARAKA-NITHI",94,50,74,124
4951,"THARAKA-NITHI","90-94",297,544,841
4952,"THARAKA-NITHI",95,45,82,127
4953,"THARAKA-NITHI",96,19,49,68
4954,"THARAKA-NITHI",97,66,79,145
4955,"THARAKA-NITHI",98,25,45,70
4956,"THARAKA-NITHI",99,56,146,202
4957,"THARAKA-NITHI","95-99",211,401,612
4958,"THARAKA-NITHI","100+",84,233,317
4959,"THARAKA-NITHI","Not Stated",5,4,9
4961,"TRANS NZOIA","Total",400606,410978,811584
4962,"TRANS NZOIA",0,9714,9683,19397
4963,"TRANS NZOIA",1,10163,10260,20423
4964,"TRANS NZOIA",2,10573,10355,20928
4965,"TRANS NZOIA",3,11546,11455,23001
4966,"TRANS NZOIA",4,11867,11404,23271
4967,"TRANS NZOIA","0 - 4",53863,53157,107020
4968,"TRANS NZOIA",5,12181,11690,23871
4969,"TRANS NZOIA",6,12278,12136,24414
4970,"TRANS NZOIA",7,11983,12106,24089
4971,"TRANS NZOIA",8,11395,11568,22963
4972,"TRANS NZOIA",9,13109,12926,26035
4973,"TRANS NZOIA","5-9",60946,60426,121372
4974,"TRANS NZOIA",10,13366,12634,26000
4975,"TRANS NZOIA",11,11998,12381,24379
4976,"TRANS NZOIA",12,13318,12764,26082
4977,"TRANS NZOIA",13,13118,12951,26069
4978,"TRANS NZOIA",14,12673,12284,24957
4979,"TRANS NZOIA","10-14",64473,63014,127487
4980,"TRANS NZOIA",15,12338,11809,24147
4981,"TRANS NZOIA",16,11272,10939,22211
4982,"TRANS NZOIA",17,11898,10804,22702
4983,"TRANS NZOIA",18,8818,8089,16907
4984,"TRANS NZOIA",19,9798,8962,18760
4985,"TRANS NZOIA","15-19",54124,50603,104727
4986,"TRANS NZOIA",20,7998,7927,15925
4987,"TRANS NZOIA",21,6567,6752,13319
4988,"TRANS NZOIA",22,6153,6599,12752
4989,"TRANS NZOIA",23,6059,6733,12792
4990,"TRANS NZOIA",24,5251,5913,11164
4991,"TRANS NZOIA","20-24",32028,33924,65952
4992,"TRANS NZOIA",25,5749,6521,12270
4993,"TRANS NZOIA",26,4498,5446,9944
4994,"TRANS NZOIA",27,5004,5563,10567
4995,"TRANS NZOIA",28,3699,4351,8050
4996,"TRANS NZOIA",29,4383,5009,9392
4997,"TRANS NZOIA","25-29",23333,26890,50223
4998,"TRANS NZOIA",30,5081,5993,11074
4999,"TRANS NZOIA",31,4054,4711,8765
5000,"TRANS NZOIA",32,5138,5995,11133
5001,"TRANS NZOIA",33,4227,5228,9455
5002,"TRANS NZOIA",34,3855,4377,8232
5003,"TRANS NZOIA","30-34",22355,26304,48659
5004,"TRANS NZOIA",35,4968,5129,10097
5005,"TRANS NZOIA",36,3501,3598,7099
5006,"TRANS NZOIA",37,3733,3530,7263
5007,"TRANS NZOIA",38,2786,2737,5523
5008,"TRANS NZOIA",39,3153,3038,6191
5009,"TRANS NZOIA","35-39",18141,18032,36173
5010,"TRANS NZOIA",40,3656,3767,7423
5011,"TRANS NZOIA",41,3611,3936,7547
5012,"TRANS NZOIA",42,3767,3940,7707
5013,"TRANS NZOIA",43,3388,3708,7096
5014,"TRANS NZOIA",44,2477,2631,5108
5015,"TRANS NZOIA","40-44",16899,17982,34881
5016,"TRANS NZOIA",45,3710,3825,7535
5017,"TRANS NZOIA",46,2720,2768,5488
5018,"TRANS NZOIA",47,2766,2928,5694
5019,"TRANS NZOIA",48,1911,2000,3911
5020,"TRANS NZOIA",49,2290,2353,4643
5021,"TRANS NZOIA","45-49",13397,13874,27271
5022,"TRANS NZOIA",50,2462,2678,5140
5023,"TRANS NZOIA",51,2174,2384,4558
5024,"TRANS NZOIA",52,1929,2161,4090
5025,"TRANS NZOIA",53,1781,1949,3730
5026,"TRANS NZOIA",54,1818,2027,3845
5027,"TRANS NZOIA","50-54",10164,11199,21363
5028,"TRANS NZOIA",55,1875,1918,3793
5029,"TRANS NZOIA",56,1737,2073,3810
5030,"TRANS NZOIA",57,1813,2546,4359
5031,"TRANS NZOIA",58,1552,1881,3433
5032,"TRANS NZOIA",59,2048,2138,4186
5033,"TRANS NZOIA","55-59",9025,10556,19581
5034,"TRANS NZOIA",60,1979,2012,3991
5035,"TRANS NZOIA",61,1670,1787,3457
5036,"TRANS NZOIA",62,1336,1417,2753
5037,"TRANS NZOIA",63,1519,1654,3173
5038,"TRANS NZOIA",64,1040,1171,2211
5039,"TRANS NZOIA","60-64",7544,8041,15585
5040,"TRANS NZOIA",65,1472,1645,3117
5041,"TRANS NZOIA",66,891,975,1866
5042,"TRANS NZOIA",67,1341,1544,2885
5043,"TRANS NZOIA",68,648,624,1272
5044,"TRANS NZOIA",69,1098,1137,2235
5045,"TRANS NZOIA","65-69",5450,5925,11375
5046,"TRANS NZOIA",70,1050,1255,2305
5047,"TRANS NZOIA",71,946,1043,1989
5048,"TRANS NZOIA",72,728,679,1407
5049,"TRANS NZOIA",73,695,764,1459
5050,"TRANS NZOIA",74,528,654,1182
5051,"TRANS NZOIA","70-74",3947,4395,8342
5052,"TRANS NZOIA",75,547,668,1215
5053,"TRANS NZOIA",76,436,612,1048
5054,"TRANS NZOIA",77,538,695,1233
5055,"TRANS NZOIA",78,299,346,645
5056,"TRANS NZOIA",79,316,537,853
5057,"TRANS NZOIA","75-79",2136,2858,4994
5058,"TRANS NZOIA",80,421,533,954
5059,"TRANS NZOIA",81,251,323,574
5060,"TRANS NZOIA",82,241,291,532
5061,"TRANS NZOIA",83,326,357,683
5062,"TRANS NZOIA",84,212,261,473
5063,"TRANS NZOIA","80-84",1451,1765,3216
5064,"TRANS NZOIA",85,206,305,511
5065,"TRANS NZOIA",86,146,193,339
5066,"TRANS NZOIA",87,214,309,523
5067,"TRANS NZOIA",88,101,103,204
5068,"TRANS NZOIA",89,162,310,472
5069,"TRANS NZOIA","85-89",829,1220,2049
5070,"TRANS NZOIA",90,54,136,190
5071,"TRANS NZOIA",91,101,114,215
5072,"TRANS NZOIA",92,51,43,94
5073,"TRANS NZOIA",93,55,75,130
5074,"TRANS NZOIA",94,36,49,85
5075,"TRANS NZOIA","90-94",297,417,714
5076,"TRANS NZOIA",95,79,114,193
5077,"TRANS NZOIA",96,23,42,65
5078,"TRANS NZOIA",97,36,47,83
5079,"TRANS NZOIA",98,15,23,38
5080,"TRANS NZOIA",99,22,53,75
5081,"TRANS NZOIA","95-99",175,279,454
5082,"TRANS NZOIA","100+",28,116,144
5083,"TRANS NZOIA","Not Stated",1,1,2
5085,"TURKANA","Total",406490,379675,786165
5086,"TURKANA",0,8006,8078,16084
5087,"TURKANA",1,9236,9013,18249
5088,"TURKANA",2,12530,12474,25004
5089,"TURKANA",3,13112,12924,26036
5090,"TURKANA",4,13480,13246,26726
5091,"TURKANA","0 - 4",56364,55735,112099
5092,"TURKANA",5,14232,13492,27724
5093,"TURKANA",6,13763,13220,26983
5094,"TURKANA",7,11882,11217,23099
5095,"TURKANA",8,14495,13737,28232
5096,"TURKANA",9,10552,10064,20616
5097,"TURKANA","5-9",64924,61730,126654
5098,"TURKANA",10,18609,17455,36064
5099,"TURKANA",11,8648,9058,17706
5100,"TURKANA",12,15267,12328,27595
5101,"TURKANA",13,11329,9272,20601
5102,"TURKANA",14,11927,9426,21353
5103,"TURKANA","10-14",65780,57539,123319
5104,"TURKANA",15,15496,11584,27080
5105,"TURKANA",16,11490,8658,20148
5106,"TURKANA",17,10536,7362,17898
5107,"TURKANA",18,11979,9094,21073
5108,"TURKANA",19,8244,6552,14796
5109,"TURKANA","15-19",57745,43250,100995
5110,"TURKANA",20,14906,11449,26355
5111,"TURKANA",21,6723,5629,12352
5112,"TURKANA",22,7433,6437,13870
5113,"TURKANA",23,6810,5867,12677
5114,"TURKANA",24,6628,5688,12316
5115,"TURKANA","20-24",42500,35070,77570
5116,"TURKANA",25,9887,8676,18563
5117,"TURKANA",26,5636,5999,11635
5118,"TURKANA",27,5513,5503,11016
5119,"TURKANA",28,5598,5164,10762
5120,"TURKANA",29,5210,5426,10636
5121,"TURKANA","25-29",31844,30768,62612
5122,"TURKANA",30,9582,9812,19394
5123,"TURKANA",31,3023,3503,6526
5124,"TURKANA",32,4080,4403,8483
5125,"TURKANA",33,2910,3549,6459
5126,"TURKANA",34,2994,3519,6513
5127,"TURKANA","30-34",22589,24786,47375
5128,"TURKANA",35,5628,5981,11609
5129,"TURKANA",36,2581,3175,5756
5130,"TURKANA",37,2254,2560,4814
5131,"TURKANA",38,2253,2511,4764
5132,"TURKANA",39,3051,3671,6722
5133,"TURKANA","35-39",15767,17898,33665
5134,"TURKANA",40,6073,5037,11110
5135,"TURKANA",41,1946,2562,4508
5136,"TURKANA",42,2515,2544,5059
5137,"TURKANA",43,1595,1971,3566
5138,"TURKANA",44,1407,1675,3082
5139,"TURKANA","40-44",13536,13789,27325
5140,"TURKANA",45,3502,3340,6842
5141,"TURKANA",46,1763,2155,3918
5142,"TURKANA",47,1482,1428,2910
5143,"TURKANA",48,1259,1211,2470
5144,"TURKANA",49,1774,2002,3776
5145,"TURKANA","45-49",9780,10136,19916
5146,"TURKANA",50,3734,3197,6931
5147,"TURKANA",51,1002,1145,2147
5148,"TURKANA",52,1101,1028,2129
5149,"TURKANA",53,762,823,1585
5150,"TURKANA",54,965,1147,2112
5151,"TURKANA","50-54",7564,7340,14904
5152,"TURKANA",55,1249,1257,2506
5153,"TURKANA",56,1070,1070,2140
5154,"TURKANA",57,669,778,1447
5155,"TURKANA",58,635,692,1327
5156,"TURKANA",59,1106,1581,2687
5157,"TURKANA","55-59",4729,5378,10107
5158,"TURKANA",60,2190,2172,4362
5159,"TURKANA",61,731,987,1718
5160,"TURKANA",62,613,709,1322
5161,"TURKANA",63,638,923,1561
5162,"TURKANA",64,484,568,1052
5163,"TURKANA","60-64",4656,5359,10015
5164,"TURKANA",65,920,1149,2069
5165,"TURKANA",66,351,396,747
5166,"TURKANA",67,518,602,1120
5167,"TURKANA",68,401,412,813
5168,"TURKANA",69,864,1216,2080
5169,"TURKANA","65-69",3054,3775,6829
5170,"TURKANA",70,1321,1446,2767
5171,"TURKANA",71,424,696,1120
5172,"TURKANA",72,372,452,824
5173,"TURKANA",73,248,380,628
5174,"TURKANA",74,489,578,1067
5175,"TURKANA","70-74",2854,3552,6406
5176,"TURKANA",75,370,398,768
5177,"TURKANA",76,182,236,418
5178,"TURKANA",77,179,242,421
5179,"TURKANA",78,164,195,359
5180,"TURKANA",79,455,586,1041
5181,"TURKANA","75-79",1350,1657,3007
5182,"TURKANA",80,451,524,975
5183,"TURKANA",81,122,196,318
5184,"TURKANA",82,69,100,169
5185,"TURKANA",83,68,131,199
5186,"TURKANA",84,93,142,235
5187,"TURKANA","80-84",803,1093,1896
5188,"TURKANA",85,110,117,227
5189,"TURKANA",86,37,58,95
5190,"TURKANA",87,66,65,131
5191,"TURKANA",88,27,38,65
5192,"TURKANA",89,175,221,396
5193,"TURKANA","85-89",415,499,914
5194,"TURKANA",90,67,102,169
5195,"TURKANA",91,33,36,69
5196,"TURKANA",92,16,11,27
5197,"TURKANA",93,7,21,28
5198,"TURKANA",94,20,19,39
5199,"TURKANA","90-94",143,189,332
5200,"TURKANA",95,18,33,51
5201,"TURKANA",96,10,13,23
5202,"TURKANA",97,9,11,20
5203,"TURKANA",98,11,8,19
5204,"TURKANA",99,20,24,44
5205,"TURKANA","95-99",68,89,157
5206,"TURKANA","100+",25,42,67
5207,"TURKANA","Not Stated","-",1,1
5209,"UASIN GISHU","Total",326269,326700,652969
5210,"UASIN GISHU",0,7050,7273,14323
5211,"UASIN GISHU",1,7386,7389,14775
5212,"UASIN GISHU",2,7766,7662,15428
5213,"UASIN GISHU",3,8038,8309,16347
5214,"UASIN GISHU",4,8736,8320,17056
5215,"UASIN GISHU","0 - 4",38976,38953,77929
5216,"UASIN GISHU",5,8302,7809,16111
5217,"UASIN GISHU",6,8727,8494,17221
5218,"UASIN GISHU",7,8788,8512,17300
5219,"UASIN GISHU",8,8328,8241,16569
5220,"UASIN GISHU",9,9578,9438,19016
5221,"UASIN GISHU","5-9",43723,42494,86217
5222,"UASIN GISHU",10,9526,9100,18626
5223,"UASIN GISHU",11,9022,9076,18098
5224,"UASIN GISHU",12,10087,9633,19720
5225,"UASIN GISHU",13,9803,9786,19589
5226,"UASIN GISHU",14,9432,9075,18507
5227,"UASIN GISHU","10-14",47870,46670,94540
5228,"UASIN GISHU",15,9307,8953,18260
5229,"UASIN GISHU",16,8783,8550,17333
5230,"UASIN GISHU",17,9190,8488,17678
5231,"UASIN GISHU",18,6857,6259,13116
5232,"UASIN GISHU",19,8286,7404,15690
5233,"UASIN GISHU","15-19",42423,39654,82077
5234,"UASIN GISHU",20,6830,6282,13112
5235,"UASIN GISHU",21,6633,6218,12851
5236,"UASIN GISHU",22,6112,5742,11854
5237,"UASIN GISHU",23,6161,5996,12157
5238,"UASIN GISHU",24,5634,5502,11136
5239,"UASIN GISHU","20-24",31370,29740,61110
5240,"UASIN GISHU",25,5920,5712,11632
5241,"UASIN GISHU",26,4583,4849,9432
5242,"UASIN GISHU",27,4574,4932,9506
5243,"UASIN GISHU",28,3315,3464,6779
5244,"UASIN GISHU",29,3869,4353,8222
5245,"UASIN GISHU","25-29",22261,23310,45571
5246,"UASIN GISHU",30,4468,5006,9474
5247,"UASIN GISHU",31,3627,3943,7570
5248,"UASIN GISHU",32,4531,5223,9754
5249,"UASIN GISHU",33,4046,4739,8785
5250,"UASIN GISHU",34,3554,4192,7746
5251,"UASIN GISHU","30-34",20226,23103,43329
5252,"UASIN GISHU",35,4914,5023,9937
5253,"UASIN GISHU",36,3227,3048,6275
5254,"UASIN GISHU",37,3573,3187,6760
5255,"UASIN GISHU",38,2300,2186,4486
5256,"UASIN GISHU",39,3186,2954,6140
5257,"UASIN GISHU","35-39",17200,16398,33598
5258,"UASIN GISHU",40,3298,3131,6429
5259,"UASIN GISHU",41,3613,3227,6840
5260,"UASIN GISHU",42,3266,3137,6403
5261,"UASIN GISHU",43,2795,3025,5820
5262,"UASIN GISHU",44,2207,2249,4456
5263,"UASIN GISHU","40-44",15179,14769,29948
5264,"UASIN GISHU",45,3906,3696,7602
5265,"UASIN GISHU",46,2626,2813,5439
5266,"UASIN GISHU",47,2691,2881,5572
5267,"UASIN GISHU",48,1681,1747,3428
5268,"UASIN GISHU",49,2255,2359,4614
5269,"UASIN GISHU","45-49",13159,13496,26655
5270,"UASIN GISHU",50,2295,2316,4611
5271,"UASIN GISHU",51,1890,1966,3856
5272,"UASIN GISHU",52,1635,1678,3313
5273,"UASIN GISHU",53,1367,1377,2744
5274,"UASIN GISHU",54,1570,1525,3095
5275,"UASIN GISHU","50-54",8757,8862,17619
5276,"UASIN GISHU",55,1490,1257,2747
5277,"UASIN GISHU",56,1332,1553,2885
5278,"UASIN GISHU",57,1513,2063,3576
5279,"UASIN GISHU",58,1501,1873,3374
5280,"UASIN GISHU",59,1535,1568,3103
5281,"UASIN GISHU","55-59",7371,8314,15685
5282,"UASIN GISHU",60,1570,1632,3202
5283,"UASIN GISHU",61,1218,1368,2586
5284,"UASIN GISHU",62,1007,1075,2082
5285,"UASIN GISHU",63,1023,1121,2144
5286,"UASIN GISHU",64,799,882,1681
5287,"UASIN GISHU","60-64",5617,6078,11695
5288,"UASIN GISHU",65,1156,1349,2505
5289,"UASIN GISHU",66,668,810,1478
5290,"UASIN GISHU",67,1220,1386,2606
5291,"UASIN GISHU",68,480,539,1019
5292,"UASIN GISHU",69,856,934,1790
5293,"UASIN GISHU","65-69",4380,5018,9398
5294,"UASIN GISHU",70,899,1160,2059
5295,"UASIN GISHU",71,759,813,1572
5296,"UASIN GISHU",72,528,553,1081
5297,"UASIN GISHU",73,491,483,974
5298,"UASIN GISHU",74,467,594,1061
5299,"UASIN GISHU","70-74",3144,3603,6747
5300,"UASIN GISHU",75,486,627,1113
5301,"UASIN GISHU",76,515,670,1185
5302,"UASIN GISHU",77,422,473,895
5303,"UASIN GISHU",78,231,237,468
5304,"UASIN GISHU",79,370,575,945
5305,"UASIN GISHU","75-79",2024,2582,4606
5306,"UASIN GISHU",80,379,560,939
5307,"UASIN GISHU",81,221,329,550
5308,"UASIN GISHU",82,222,175,397
5309,"UASIN GISHU",83,229,249,478
5310,"UASIN GISHU",84,215,320,535
5311,"UASIN GISHU","80-84",1266,1633,2899
5312,"UASIN GISHU",85,172,274,446
5313,"UASIN GISHU",86,135,165,300
5314,"UASIN GISHU",87,159,178,337
5315,"UASIN GISHU",88,93,86,179
5316,"UASIN GISHU",89,145,327,472
5317,"UASIN GISHU","85-89",704,1030,1734
5318,"UASIN GISHU",90,88,179,267
5319,"UASIN GISHU",91,68,92,160
5320,"UASIN GISHU",92,57,64,121
5321,"UASIN GISHU",93,65,53,118
5322,"UASIN GISHU",94,40,90,130
5323,"UASIN GISHU","90-94",318,478,796
5324,"UASIN GISHU",95,107,136,243
5325,"UASIN GISHU",96,33,49,82
5326,"UASIN GISHU",97,43,51,94
5327,"UASIN GISHU",98,22,20,42
5328,"UASIN GISHU",99,33,75,108
5329,"UASIN GISHU","95-99",238,331,569
5330,"UASIN GISHU","100+",58,182,240
5331,"UASIN GISHU","Not Stated",5,2,7
5333,"VIHIGA","Total",255727,275892,531619
5334,"VIHIGA",0,5253,5533,10786
5335,"VIHIGA",1,5446,5620,11066
5336,"VIHIGA",2,5681,5684,11365
5337,"VIHIGA",3,6155,6074,12229
5338,"VIHIGA",4,6290,6300,12590
5339,"VIHIGA","0 - 4",28825,29211,58036
5340,"VIHIGA",5,6575,6279,12854
5341,"VIHIGA",6,6802,6931,13733
5342,"VIHIGA",7,7203,7364,14567
5343,"VIHIGA",8,7023,7226,14249
5344,"VIHIGA",9,7780,7898,15678
5345,"VIHIGA","5-9",35383,35698,71081
5346,"VIHIGA",10,7967,7723,15690
5347,"VIHIGA",11,7683,7965,15648
5348,"VIHIGA",12,8494,8358,16852
5349,"VIHIGA",13,8268,8462,16730
5350,"VIHIGA",14,7752,7696,15448
5351,"VIHIGA","10-14",40164,40204,80368
5352,"VIHIGA",15,7534,7501,15035
5353,"VIHIGA",16,7386,7390,14776
5354,"VIHIGA",17,7453,7077,14530
5355,"VIHIGA",18,5996,5768,11764
5356,"VIHIGA",19,5897,5441,11338
5357,"VIHIGA","15-19",34266,33177,67443
5358,"VIHIGA",20,4832,4899,9731
5359,"VIHIGA",21,3866,3805,7671
5360,"VIHIGA",22,3555,3648,7203
5361,"VIHIGA",23,3236,3699,6935
5362,"VIHIGA",24,2819,3283,6102
5363,"VIHIGA","20-24",18308,19334,37642
5364,"VIHIGA",25,2801,3389,6190
5365,"VIHIGA",26,2437,3115,5552
5366,"VIHIGA",27,2574,3160,5734
5367,"VIHIGA",28,2262,2725,4987
5368,"VIHIGA",29,2362,2891,5253
5369,"VIHIGA","25-29",12436,15280,27716
5370,"VIHIGA",30,3028,3845,6873
5371,"VIHIGA",31,2215,2889,5104
5372,"VIHIGA",32,2860,3620,6480
5373,"VIHIGA",33,2431,2930,5361
5374,"VIHIGA",34,2371,2739,5110
5375,"VIHIGA","30-34",12905,16023,28928
5376,"VIHIGA",35,2910,3211,6121
5377,"VIHIGA",36,2225,2533,4758
5378,"VIHIGA",37,2468,2579,5047
5379,"VIHIGA",38,1949,2077,4026
5380,"VIHIGA",39,2150,2310,4460
5381,"VIHIGA","35-39",11702,12710,24412
5382,"VIHIGA",40,2476,2716,5192
5383,"VIHIGA",41,2252,2524,4776
5384,"VIHIGA",42,2332,2737,5069
5385,"VIHIGA",43,2083,2450,4533
5386,"VIHIGA",44,1747,1830,3577
5387,"VIHIGA","40-44",10890,12257,23147
5388,"VIHIGA",45,2291,2435,4726
5389,"VIHIGA",46,1935,2028,3963
5390,"VIHIGA",47,2101,2296,4397
5391,"VIHIGA",48,1540,1621,3161
5392,"VIHIGA",49,1667,1903,3570
5393,"VIHIGA","45-49",9534,10283,19817
5394,"VIHIGA",50,1964,2469,4433
5395,"VIHIGA",51,1668,2052,3720
5396,"VIHIGA",52,1541,1810,3351
5397,"VIHIGA",53,1296,1643,2939
5398,"VIHIGA",54,1500,1802,3302
5399,"VIHIGA","50-54",7969,9776,17745
5400,"VIHIGA",55,1618,1892,3510
5401,"VIHIGA",56,1538,1934,3472
5402,"VIHIGA",57,1580,2364,3944
5403,"VIHIGA",58,1245,1585,2830
5404,"VIHIGA",59,1606,1985,3591
5405,"VIHIGA","55-59",7587,9760,17347
5406,"VIHIGA",60,1720,2258,3978
5407,"VIHIGA",61,1640,1775,3415
5408,"VIHIGA",62,1485,1670,3155
5409,"VIHIGA",63,1476,1823,3299
5410,"VIHIGA",64,1313,1552,2865
5411,"VIHIGA","60-64",7634,9078,16712
5412,"VIHIGA",65,1634,1967,3601
5413,"VIHIGA",66,1169,1377,2546
5414,"VIHIGA",67,1579,1879,3458
5415,"VIHIGA",68,804,949,1753
5416,"VIHIGA",69,1244,1384,2628
5417,"VIHIGA","65-69",6430,7556,13986
5418,"VIHIGA",70,1468,1790,3258
5419,"VIHIGA",71,1119,1069,2188
5420,"VIHIGA",72,987,1072,2059
5421,"VIHIGA",73,838,927,1765
5422,"VIHIGA",74,775,910,1685
5423,"VIHIGA","70-74",5187,5768,10955
5424,"VIHIGA",75,566,848,1414
5425,"VIHIGA",76,701,1176,1877
5426,"VIHIGA",77,640,815,1455
5427,"VIHIGA",78,418,465,883
5428,"VIHIGA",79,497,718,1215
5429,"VIHIGA","75-79",2822,4022,6844
5430,"VIHIGA",80,482,860,1342
5431,"VIHIGA",81,405,587,992
5432,"VIHIGA",82,387,506,893
5433,"VIHIGA",83,367,576,943
5434,"VIHIGA",84,326,451,777
5435,"VIHIGA","80-84",1967,2980,4947
5436,"VIHIGA",85,249,450,699
5437,"VIHIGA",86,232,394,626
5438,"VIHIGA",87,266,425,691
5439,"VIHIGA",88,157,175,332
5440,"VIHIGA",89,173,337,510
5441,"VIHIGA","85-89",1077,1781,2858
5442,"VIHIGA",90,134,149,283
5443,"VIHIGA",91,114,174,288
5444,"VIHIGA",92,80,110,190
5445,"VIHIGA",93,63,79,142
5446,"VIHIGA",94,44,73,117
5447,"VIHIGA","90-94",435,585,1020
5448,"VIHIGA",95,54,113,167
5449,"VIHIGA",96,32,60,92
5450,"VIHIGA",97,39,68,107
5451,"VIHIGA",98,19,24,43
5452,"VIHIGA",99,16,53,69
5453,"VIHIGA","95-99",160,318,478
5454,"VIHIGA","100+",42,88,130
5455,"VIHIGA","Not Stated",4,3,7
5457,"WAJIR","Total",320562,283500,604062
5458,"WAJIR",0,4340,4633,8973
5459,"WAJIR",1,7497,7450,14947
5460,"WAJIR",2,13624,13852,27476
5461,"WAJIR",3,9876,9838,19714
5462,"WAJIR",4,13875,13773,27648
5463,"WAJIR","0 - 4",49212,49546,98758
5464,"WAJIR",5,9819,9779,19598
5465,"WAJIR",6,14410,13774,28184
5466,"WAJIR",7,8580,8168,16748
5467,"WAJIR",8,14755,13679,28434
5468,"WAJIR",9,8129,7857,15986
5469,"WAJIR","5-9",55693,53257,108950
5470,"WAJIR",10,16545,14687,31232
5471,"WAJIR",11,7002,7305,14307
5472,"WAJIR",12,13729,9894,23623
5473,"WAJIR",13,8643,6175,14818
5474,"WAJIR",14,11091,7850,18941
5475,"WAJIR","10-14",57010,45911,102921
5476,"WAJIR",15,11435,7623,19058
5477,"WAJIR",16,9923,6915,16838
5478,"WAJIR",17,8918,6121,15039
5479,"WAJIR",18,8974,6937,15911
5480,"WAJIR",19,4227,3896,8123
5481,"WAJIR","15-19",43477,31492,74969
5482,"WAJIR",20,9726,8888,18614
5483,"WAJIR",21,3934,3701,7635
5484,"WAJIR",22,4675,4748,9423
5485,"WAJIR",23,3543,3688,7231
5486,"WAJIR",24,3509,3529,7038
5487,"WAJIR","20-24",25387,24554,49941
5488,"WAJIR",25,6787,7176,13963
5489,"WAJIR",26,3476,3629,7105
5490,"WAJIR",27,3022,3456,6478
5491,"WAJIR",28,4265,4926,9191
5492,"WAJIR",29,2684,3133,5817
5493,"WAJIR","25-29",20234,22320,42554
5494,"WAJIR",30,8435,8275,16710
5495,"WAJIR",31,2532,2994,5526
5496,"WAJIR",32,3079,3121,6200
5497,"WAJIR",33,1905,2072,3977
5498,"WAJIR",34,1881,1948,3829
5499,"WAJIR","30-34",17832,18410,36242
5500,"WAJIR",35,4598,4489,9087
5501,"WAJIR",36,2060,2142,4202
5502,"WAJIR",37,1644,1817,3461
5503,"WAJIR",38,2327,2547,4874
5504,"WAJIR",39,1631,1713,3344
5505,"WAJIR","35-39",12260,12708,24968
5506,"WAJIR",40,6605,4813,11418
5507,"WAJIR",41,1917,1795,3712
5508,"WAJIR",42,2190,1678,3868
5509,"WAJIR",43,1293,951,2244
5510,"WAJIR",44,744,631,1375
5511,"WAJIR","40-44",12749,9868,22617
5512,"WAJIR",45,3082,2093,5175
5513,"WAJIR",46,977,643,1620
5514,"WAJIR",47,900,583,1483
5515,"WAJIR",48,1228,840,2068
5516,"WAJIR",49,935,573,1508
5517,"WAJIR","45-49",7122,4732,11854
5518,"WAJIR",50,3714,1991,5705
5519,"WAJIR",51,747,433,1180
5520,"WAJIR",52,1175,620,1795
5521,"WAJIR",53,583,280,863
5522,"WAJIR",54,727,393,1120
5523,"WAJIR","50-54",6946,3717,10663
5524,"WAJIR",55,926,491,1417
5525,"WAJIR",56,685,407,1092
5526,"WAJIR",57,494,377,871
5527,"WAJIR",58,647,407,1054
5528,"WAJIR",59,732,380,1112
5529,"WAJIR","55-59",3484,2062,5546
5530,"WAJIR",60,2076,1032,3108
5531,"WAJIR",61,623,345,968
5532,"WAJIR",62,490,202,692
5533,"WAJIR",63,409,203,612
5534,"WAJIR",64,321,178,499
5535,"WAJIR","60-64",3919,1960,5879
5536,"WAJIR",65,586,336,922
5537,"WAJIR",66,256,189,445
5538,"WAJIR",67,252,133,385
5539,"WAJIR",68,297,143,440
5540,"WAJIR",69,373,156,529
5541,"WAJIR","65-69",1764,957,2721
5542,"WAJIR",70,945,569,1514
5543,"WAJIR",71,282,228,510
5544,"WAJIR",72,227,90,317
5545,"WAJIR",73,142,50,192
5546,"WAJIR",74,143,60,203
5547,"WAJIR","70-74",1739,997,2736
5548,"WAJIR",75,260,96,356
5549,"WAJIR",76,116,60,176
5550,"WAJIR",77,94,47,141
5551,"WAJIR",78,118,58,176
5552,"WAJIR",79,145,56,201
5553,"WAJIR","75-79",733,317,1050
5554,"WAJIR",80,364,260,624
5555,"WAJIR",81,108,110,218
5556,"WAJIR",82,72,24,96
5557,"WAJIR",83,42,26,68
5558,"WAJIR",84,43,31,74
5559,"WAJIR","80-84",629,451,1080
5560,"WAJIR",85,62,31,93
5561,"WAJIR",86,29,19,48
5562,"WAJIR",87,34,20,54
5563,"WAJIR",88,27,10,37
5564,"WAJIR",89,34,35,69
5565,"WAJIR","85-89",186,115,301
5566,"WAJIR",90,72,57,129
5567,"WAJIR",91,24,19,43
5568,"WAJIR",92,22,7,29
5569,"WAJIR",93,10,6,16
5570,"WAJIR",94,6,3,9
5571,"WAJIR","90-94",134,92,226
5572,"WAJIR",95,20,8,28
5573,"WAJIR",96,9,6,15
5574,"WAJIR",97,2,2,4
5575,"WAJIR",98,8,2,10
5576,"WAJIR",99,3,6,9
5577,"WAJIR","95-99",42,24,66
5578,"WAJIR","100+",10,9,19
5579,"WAJIR","Not Stated","-",1,1
5581,"WEST POKOT","Total",291469,297916,589385
5582,"WEST POKOT",0,9473,9605,19078
5583,"WEST POKOT",1,10396,10206,20602
5584,"WEST POKOT",2,11601,11414,23015
5585,"WEST POKOT",3,11557,11694,23251
5586,"WEST POKOT",4,12014,11697,23711
5587,"WEST POKOT","0 - 4",55041,54616,109657
5588,"WEST POKOT",5,11199,10917,22116
5589,"WEST POKOT",6,11666,12081,23747
5590,"WEST POKOT",7,9837,9808,19645
5591,"WEST POKOT",8,10919,11178,22097
5592,"WEST POKOT",9,8629,8411,17040
5593,"WEST POKOT","5-9",52250,52395,104645
5594,"WEST POKOT",10,12151,12282,24433
5595,"WEST POKOT",11,7057,7633,14690
5596,"WEST POKOT",12,10516,9727,20243
5597,"WEST POKOT",13,8146,7970,16116
5598,"WEST POKOT",14,8263,7717,15980
5599,"WEST POKOT","10-14",46133,45329,91462
5600,"WEST POKOT",15,8870,8080,16950
5601,"WEST POKOT",16,6997,6623,13620
5602,"WEST POKOT",17,6142,5531,11673
5603,"WEST POKOT",18,5796,5719,11515
5604,"WEST POKOT",19,5287,5275,10562
5605,"WEST POKOT","15-19",33092,31228,64320
5606,"WEST POKOT",20,6580,7620,14200
5607,"WEST POKOT",21,4367,4731,9098
5608,"WEST POKOT",22,3972,4570,8542
5609,"WEST POKOT",23,4626,4974,9600
5610,"WEST POKOT",24,3858,4278,8136
5611,"WEST POKOT","20-24",23403,26173,49576
5612,"WEST POKOT",25,5533,6032,11565
5613,"WEST POKOT",26,3437,3695,7132
5614,"WEST POKOT",27,3530,3585,7115
5615,"WEST POKOT",28,2820,3280,6100
5616,"WEST POKOT",29,2974,3407,6381
5617,"WEST POKOT","25-29",18294,19999,38293
5618,"WEST POKOT",30,5024,5633,10657
5619,"WEST POKOT",31,2775,3107,5882
5620,"WEST POKOT",32,3083,3145,6228
5621,"WEST POKOT",33,2625,2840,5465
5622,"WEST POKOT",34,2135,2292,4427
5623,"WEST POKOT","30-34",15642,17017,32659
5624,"WEST POKOT",35,4310,4413,8723
5625,"WEST POKOT",36,1662,1629,3291
5626,"WEST POKOT",37,1574,1503,3077
5627,"WEST POKOT",38,1132,1214,2346
5628,"WEST POKOT",39,1519,1458,2977
5629,"WEST POKOT","35-39",10197,10217,20414
5630,"WEST POKOT",40,2756,2722,5478
5631,"WEST POKOT",41,1844,1790,3634
5632,"WEST POKOT",42,2047,2028,4075
5633,"WEST POKOT",43,1383,1534,2917
5634,"WEST POKOT",44,970,1069,2039
5635,"WEST POKOT","40-44",9000,9143,18143
5636,"WEST POKOT",45,2753,2730,5483
5637,"WEST POKOT",46,1699,1641,3340
5638,"WEST POKOT",47,1367,1299,2666
5639,"WEST POKOT",48,951,828,1779
5640,"WEST POKOT",49,1309,1409,2718
5641,"WEST POKOT","45-49",8079,7907,15986
5642,"WEST POKOT",50,2267,2284,4551
5643,"WEST POKOT",51,943,963,1906
5644,"WEST POKOT",52,785,840,1625
5645,"WEST POKOT",53,562,589,1151
5646,"WEST POKOT",54,871,913,1784
5647,"WEST POKOT","50-54",5428,5589,11017
5648,"WEST POKOT",55,1095,1076,2171
5649,"WEST POKOT",56,853,766,1619
5650,"WEST POKOT",57,627,625,1252
5651,"WEST POKOT",58,558,611,1169
5652,"WEST POKOT",59,738,991,1729
5653,"WEST POKOT","55-59",3871,4069,7940
5654,"WEST POKOT",60,1410,1768,3178
5655,"WEST POKOT",61,618,738,1356
5656,"WEST POKOT",62,495,553,1048
5657,"WEST POKOT",63,564,752,1316
5658,"WEST POKOT",64,489,538,1027
5659,"WEST POKOT","60-64",3576,4349,7925
5660,"WEST POKOT",65,873,1236,2109
5661,"WEST POKOT",66,379,444,823
5662,"WEST POKOT",67,588,562,1150
5663,"WEST POKOT",68,333,372,705
5664,"WEST POKOT",69,700,1052,1752
5665,"WEST POKOT","65-69",2873,3666,6539
5666,"WEST POKOT",70,1045,1268,2313
5667,"WEST POKOT",71,407,577,984
5668,"WEST POKOT",72,375,372,747
5669,"WEST POKOT",73,253,317,570
5670,"WEST POKOT",74,304,449,753
5671,"WEST POKOT","70-74",2384,2983,5367
5672,"WEST POKOT",75,362,432,794
5673,"WEST POKOT",76,179,181,360
5674,"WEST POKOT",77,176,202,378
5675,"WEST POKOT",78,103,132,235
5676,"WEST POKOT",79,263,430,693
5677,"WEST POKOT","75-79",1083,1377,2460
5678,"WEST POKOT",80,296,462,758
5679,"WEST POKOT",81,96,128,224
5680,"WEST POKOT",82,66,81,147
5681,"WEST POKOT",83,69,113,182
5682,"WEST POKOT",84,71,133,204
5683,"WEST POKOT","80-84",598,917,1515
5684,"WEST POKOT",85,80,127,207
5685,"WEST POKOT",86,33,39,72
5686,"WEST POKOT",87,40,57,97
5687,"WEST POKOT",88,25,48,73
5688,"WEST POKOT",89,91,191,282
5689,"WEST POKOT","85-89",269,462,731
5690,"WEST POKOT",90,62,123,185
5691,"WEST POKOT",91,25,45,70
5692,"WEST POKOT",92,14,17,31
5693,"WEST POKOT",93,14,36,50
5694,"WEST POKOT",94,24,26,50
5695,"WEST POKOT","90-94",139,247,386
5696,"WEST POKOT",95,33,45,78
5697,"WEST POKOT",96,12,17,29
5698,"WEST POKOT",97,7,16,23
5699,"WEST POKOT",98,9,9,18
5700,"WEST POKOT",99,16,45,61
5701,"WEST POKOT","95-99",77,132,209
5702,"WEST POKOT","100+",38,100,138
5703,"WEST POKOT","Not Stated",2,1,3
